,index,count,cum_sum,cum_percent,meal_super_category
0,Beilagen,392239,392239,8.975628397,side_dish
1,Essen,143672,535911,12.26328333,main_dish
2,Kuchen und Gebäck,104662,640573,14.65827011,dessert
3,Desserts,101675,742248,16.98490519,dessert
4,Salate,92911,835159,19.11099314,salad
5,Hauptgerichte,84765,919924,21.05067568,main_dish
6,Vegetarisch,81995,1001919,22.92697215,main_dish
7,Beilage,78763,1080682,24.72931057,side_dish
8,Gericht,75418,1156100,26.45510515,mix
9,Angebote,71753,1227853,28.09703333,main_dish
10,Essen 1,56747,1284600,29.39557831,mix
11,Essen 2,54475,1339075,30.64213298,mix
12,Brötchen,51205,1390280,31.81386004,baked_goods
13,Kürbiskernbrötchen,44670,1434950,32.83604631,baked_goods
14,Roggenbrötchen,43648,1478598,33.83484609,baked_goods
15,Käsebrötchen,43067,1521665,34.82035082,baked_goods
16,Hauptessen,42773,1564438,35.79912793,main_dish
17,Mohnbrötchen,41741,1606179,36.75428972,baked_goods
18,Dessert,40976,1647155,37.69194596,dessert
19,Aktionsstand,40397,1687552,38.61635292,main_dish
20,Mensa,39419,1726971,39.51838025,mix
21,Baguettebrötchen,39290,1766261,40.41745566,baked_goods
22,Aktion,38849,1805110,41.30643964,mix
23,Eintopf,37485,1842595,42.16421112,soup
24,Essen 3,35843,1878438,42.98440863,main_dish
25,Urknacker,35523,1913961,43.79728355,baked_goods
26,Vorspeisen,33765,1947726,44.56993006,other
27,Suppen,33395,1981121,45.33410983,soup
28,Tellergericht,31374,2012495,46.05204294,main_dish
29,Pastateller,30938,2043433,46.75999904,main_dish
30,Bagels,30891,2074324,47.46687963,baked_goods
31,Wahlmenü (Beilage),28685,2103009,48.1232802,side_dish
32,Pasta,28040,2131049,48.76492119,main_dish
33,Sesambrötchen,27833,2158882,49.40182538,baked_goods
34,Buffet,27812,2186694,50.03824903,mix
35,Hauptkomponenten,27699,2214393,50.6720869,main_dish
36,Hauptgericht,27404,2241797,51.29917426,main_dish
37,Laugengebäck,27320,2269117,51.92433945,baked_goods
38,Vegan,25926,2295043,52.51760565,main_dish
39,Wahlmenü (Gemüse),25835,2320878,53.1087895,side_dish
40,Wahlessen 1,25543,2346421,53.69329149,mix
41,Beliebt und gerne gegessen,24713,2371134,54.25880054,main_dish
42,Menü 1,24159,2395293,54.81163237,mix
43,Snacks,23780,2419073,55.35579153,baked_goods
44,Croissants,23167,2442240,55.88592337,baked_goods
45,Wahlessen 2,22757,2464997,56.40667316,mix
46,Tagesangebot,22107,2487104,56.91254896,mix
47,Essen 4,22054,2509158,57.41721195,main_dish
48,Aus dem Suppentopf und Süßes,22040,2531198,57.92155458,mix
49,Nachspeisen,21982,2553180,58.42457,dessert
50,Campus Spezial,21484,2574664,58.91618965,main_dish
51,Fleisch,21159,2595823,59.40037231,main_dish
52,Auswahlessen 1,20459,2616282,59.86853682,main_dish
53,Gemüse,20163,2636445,60.32992795,side_dish
54,Angebot 1,19987,2656432,60.78729166,main_dish
55,Pasta-Bar pro 100g,19274,2675706,61.22833975,main_dish
56,Mittagessen,18752,2694458,61.65744289,main_dish
57,Sättigungsbeilage,18636,2713094,62.08389158,side_dish
58,Vegetarisches Menü,18529,2731623,62.5078918,mix
59,Angebot 2,17932,2749555,62.91823082,main_dish
60,Tigerbrötchen,16753,2766308,63.30159072,baked_goods
61,Auswahlessen 2,16687,2782995,63.68344033,main_dish
62,Mehrkornbrötchen,16680,2799675,64.06512976,baked_goods
63,Wahlmenü (Dessert),16458,2816133,64.44173916,dessert
64,Dinkelbrötchen,16433,2832566,64.81777648,baked_goods
65,Gemüsebeilage,16137,2848703,65.18704041,side_dish
66,Fleischgericht,15791,2864494,65.5483868,mix
67,Wahlmenü (Komponente mit Fleisch),15652,2880146,65.90655245,main_dish
68,Wahlmenü (Komponente ohne Fleisch),15651,2895797,66.26469521,main_dish
69,Vegetarisches Gericht,15282,2911079,66.61439413,mix
70,Gut und günstig,15217,2926296,66.96260565,main_dish
71,Pizza,15201,2941497,67.31045104,main_dish
72,Angebot 3,15172,2956669,67.65763282,main_dish
73,Wahlmenü (Salat),15094,2971763,68.00302972,salad
74,Linie 4/5,14820,2986583,68.34215666,mix
75,Tagesgericht 1,14769,3001352,68.68011657,main_dish
76,Wok,14747,3016099,69.01757305,main_dish
77,Gersterling,14630,3030729,69.35235221,baked_goods
78,Klassiker,14169,3044898,69.67658228,main_dish
79,Essen I,13680,3058578,69.98962253,main_dish
80,Essen II,13264,3071842,70.29314343,main_dish
81,Gemüsebeilagen,13246,3085088,70.59625244,side_dish
82,Pasta-Teller,13015,3098103,70.89407546,main_dish
83,Grill,12573,3110676,71.18178417,main_dish
84,Salatbuffet,12447,3123123,71.46660961,salad
85,Schneller Teller,12220,3135343,71.7462406,mix
86,Suppe,12218,3147561,72.02582582,soup
87,Essen 5,12149,3159710,72.30383211,main_dish
88,Aktionen,12144,3171854,72.58172399,main_dish
89,Sättigungsbeilagen,11965,3183819,72.85551979,side_dish
90,Smoothie,11891,3195710,73.12762226,other
91,Wahlmenü (Suppe),11798,3207508,73.39759659,soup
92,Angebot 4,11661,3219169,73.66443595,main_dish
93,Hauptbeilagen,11084,3230253,73.91807178,side_dish
94,WOK 2 Aktion,10792,3241045,74.16502576,main_dish
95,Empfehlung des Tages,10516,3251561,74.40566401,main_dish
96,Gut & Günstig,9952,3261513,74.63339622,mix
97,Imbissangebot,9917,3271430,74.86032753,mix
98,Tagesgericht,9914,3281344,75.08719018,main_dish
99,Aktions-Theke,9731,3291075,75.30986523,mix
100,Essen 6,9402,3300477,75.52501176,main_dish
101,Cafeteria Heiße Theke,9178,3309655,75.73503248,other
102,Self-Service,8846,3318501,75.93745602,mix
103,Gemüse-Bar pro 100g,8748,3327249,76.13763703,side_dish
104,Menü 2,8712,3335961,76.33699424,main_dish
105,Menü I,8568,3344529,76.5330563,main_dish
106,L6 Update,8566,3353095,76.72907258,mix
107,Menü,8490,3361585,76.92334976,main_dish
108,Dessertauswahl,8464,3370049,77.11703198,dessert
109,Tagesgericht 4,8414,3378463,77.30957004,main_dish
110,Linie 2,8278,3386741,77.49899601,mix
111,Nebenbeilage,7859,3394600,77.67883397,side_dish
112,Geflügel,7702,3402302,77.8550793,main_dish
113,Querbeet,7634,3409936,78.02976857,mix
114,Tagesgericht 3,7581,3417517,78.20324505,main_dish
115,Schwein,7384,3424901,78.37221356,main_dish
116,Linie 3,7275,3432176,78.53868782,mix
117,Pasta Buffetpro 100g,7267,3439443,78.70497901,main_dish
118,Mittag Ausgabe A,7206,3446649,78.86987434,main_dish
119,Aktionstheke,7033,3453682,79.0308109,mix
120,WOK,7008,3460690,79.19117538,main_dish
121,Tagessuppe,6981,3467671,79.35092202,soup
122,Veganes Gericht,6967,3474638,79.51034829,main_dish
123,Fischgericht,6603,3481241,79.66144513,mix
124,Salat,6457,3487698,79.80920105,salad
125,Cafeteria,6427,3494125,79.95627047,main_dish
126,Essen 7,6405,3500530,80.10283647,main_dish
127,B,6359,3506889,80.24834985,mix
128,Pizza Classics,6205,3513094,80.39033923,main_dish
129,Sonnenblumenkernbrötchen,6105,3519199,80.53004031,baked_goods
130,Potatoebrötchen dunkel,6093,3525292,80.66946679,baked_goods
131,Gut & Günstig 1,5864,3531156,80.80365305,mix
132,Potatoebrötchen hell,5789,3536945,80.93612308,baked_goods
133,"Cafeteria "" Snack it """,5725,3542670,81.0671286,mix
134,E,5598,3548268,81.19522797,mix
135,Beilagenauswahl,5435,3553703,81.3195974,side_dish
136,Gemüse/Salat,5407,3559110,81.4433261,mix
137,Tagesessen,5357,3564467,81.56591065,main_dish
138,"Pasta, Suppen & Co.",5346,3569813,81.68824348,mix
139,Mittag Ausgabe B,5260,3575073,81.80860838,main_dish
140,Hauptkomponente,5214,3580287,81.92792065,main_dish
141,Mittagsangebot,5154,3585441,82.04585994,main_dish
142,Vorspeise,5153,3590594,82.16377635,other
143,Linie 1,4954,3595548,82.27713902,mix
144,Sonstige,4942,3600490,82.3902271,mix
145,Aus dem Wok,4941,3605431,82.5032923,main_dish
146,Otto-Berndt-Halle,4910,3610341,82.61564812,mix
147,WOK 1 Aktion,4860,3615201,82.72685979,main_dish
148,mensaVital,4798,3619999,82.83665271,main_dish
149,Essen 8,4739,3624738,82.94509553,main_dish
150,GreenCorner,4693,3629431,83.05248573,main_dish
151,Mittag Ausgabe C,4683,3634114,83.1596471,main_dish
152,Menü 3,4634,3638748,83.2656872,main_dish
153,Zusatzangebot,4562,3643310,83.37007971,main_dish
154,Wahlessen,4551,3647861,83.47422052,mix
155,Täglich,4534,3652395,83.57797231,mix
156,A+B,4527,3656922,83.68156392,mix
157,Wahlessen 3,4384,3661306,83.78188325,mix
158,Speisenangebot,4308,3665614,83.88046347,main_dish
159,Curry Queen,4239,3669853,83.97746476,mix
160,FRIENDS,4217,3674070,84.07396263,main_dish
161,SÜSSE ECKE,4215,3678285,84.17041472,dessert
162,Menü II,4200,3682485,84.26652357,main_dish
163,Pizza des Tages,4138,3686623,84.36121367,main_dish
164,Tagesgericht 2,4091,3690714,84.45482827,main_dish
165,QUEERBEET,4084,3694798,84.54828268,main_dish
166,Tagesgericht 2 (Vegetarisch),4044,3698842,84.64082178,main_dish
167,Self-Service Arcisstraße,4036,3702878,84.7331778,mix
168,EVERGREENS,4031,3706909,84.82541942,main_dish
169,Menü II vegetarisch,3975,3710884,84.91637958,main_dish
170,Mittag Ausgabe D,3971,3714855,85.00724821,main_dish
171,Aktionsessen 4,3937,3718792,85.09733881,main_dish
172,Free Flow,3885,3722677,85.1862395,mix
173,Dessertbuffet,3804,3726481,85.27328666,dessert
174,MEER,3804,3730285,85.36033382,main_dish
175,Front Cooking,3793,3734078,85.44712926,mix
176,Burger Classics,3785,3737863,85.53374164,main_dish
177,Bistro,3761,3741624,85.61980483,mix
178,Suppenstation,3747,3745371,85.70554765,soup
179,Rind,3689,3749060,85.78996326,main_dish
180,Abendangebot,3646,3752706,85.8733949,main_dish
181,Komplettmenü,3604,3756310,85.95586544,main_dish
182,Classic 1,3603,3759913,86.03831311,main_dish
183,VEGAN,3588,3763501,86.12041752,main_dish
184,Cafeteria Pizza & Co,3583,3767084,86.20240753,main_dish
185,Extra Essen,3537,3770621,86.28334491,mix
186,Essen 9,3461,3774082,86.36254318,main_dish
187,Ciabattabrötchen,3344,3777426,86.43906413,baked_goods
188,Schnitzelbar,3343,3780769,86.5155622,main_dish
189,MUNTER,3328,3784097,86.59171702,mix
190,Kornspitz,3323,3787420,86.66775743,baked_goods
191,zur Pizza,3321,3790741,86.74375207,main_dish
192,Tagesmenü,3254,3793995,86.81821354,main_dish
193,Classic 2,3230,3797225,86.89212582,main_dish
194,Heimspiel,3220,3800445,86.96580928,mix
195,Special,3191,3803636,87.03882912,mix
196,"Vegan, Eintopf, Suppe",3166,3806802,87.11127689,mix
197,Mittag Ausgabe A2,3157,3809959,87.18351871,mix
198,Menü vegetarisch,3122,3813081,87.25495962,main_dish
199,Vital - Essen,3080,3816161,87.32543944,main_dish
200,Terrine,2971,3819132,87.39342501,soup
201,zur Pasta,2958,3822090,87.4611131,main_dish
202,Sprintmenü,2931,3825021,87.52818335,main_dish
203,Pastabar,2930,3827951,87.59523071,main_dish
204,Cafeteria Menü,2921,3830872,87.66207213,main_dish
205,Aufläufe & Gratin,2887,3833759,87.72813552,main_dish
206,Wellenreiterbrötchen,2876,3836635,87.7939472,baked_goods
207,Ausgabe 2,2835,3839470,87.85882068,main_dish
208,D,2825,3842295,87.92346532,main_dish
209,Marktrestaurant,2818,3845113,87.98794978,main_dish
210,Essen B,2798,3847911,88.05197658,main_dish
211,Food Angebot im Schlüters,2776,3850687,88.11549995,main_dish
212,Essen A,2760,3853447,88.1786572,soup
213,Mensacafé,2758,3856205,88.24176868,mix
214,Bio,2749,3858954,88.30467421,mix
215,Rind Schwein,2724,3861678,88.36700766,main_dish
216,Aktionsessen 5,2720,3864398,88.42924958,main_dish
217,Pommes & Co,2705,3867103,88.49114826,mix
218,Gericht mit Fleisch oder Fisch,2682,3869785,88.55252063,main_dish
219,Angebot,2681,3872466,88.61387011,main_dish
220,Tagesaktion,2618,3875084,88.67377796,main_dish
221,Beilage 3,2577,3877661,88.7327476,side_dish
222,Essen C,2565,3880226,88.79144265,main_dish
223,Wok & Grill,2514,3882740,88.84897066,main_dish
224,Essen 10,2502,3885242,88.90622408,main_dish
225,Eintopf / Suppe,2493,3887735,88.96327155,soup
226,Auflauf,2472,3890207,89.01983847,main_dish
227,Ausgabe 1,2465,3892672,89.07624521,main_dish
228,Beilage 2,2419,3895091,89.13159933,side_dish
229,MA(h)l was anderes,2381,3897472,89.1860839,mix
230,Essen V,2372,3899844,89.24036251,main_dish
231,WOK-Pfanne Premium,2366,3902210,89.29450383,main_dish
232,Ausgabe 4,2351,3904561,89.34830191,main_dish
233,Otto B.,2338,3906899,89.4018025,main_dish
234,Fisch MSC Fisch,2311,3909210,89.45468525,main_dish
235,Sonstiges,2280,3911490,89.50685863,mix
236,Suppe & Co,2275,3913765,89.55891759,mix
237,Mittag Ausgabe B2,2261,3916026,89.61065618,main_dish
238,[Kœri]werk,2227,3918253,89.66161676,mix
239,Beilage 1,2225,3920478,89.71253156,side_dish
240,Alternativ-Angebot,2205,3922683,89.76298871,main_dish
241,A,2200,3924883,89.81333144,mix
242,Suppe & Co.,2197,3927080,89.86360552,soup
243,CampusKlassiker,2185,3929265,89.91360501,main_dish
244,Dessert 1,2173,3931438,89.9633299,dessert
245,Fisch,2167,3933605,90.01291749,main_dish
246,Cafeteria ab 14:30,2160,3935765,90.0623449,baked_goods
247,Wok und Pfanne,2157,3937922,90.11170366,mix
248,Ausgabe 3,2154,3940076,90.16099377,
249,Grillstation,2153,3942229,90.21026099,
250,Länder-Mensa,2092,3944321,90.25813235,
251,Aktionsessen 6,2073,3946394,90.30556894,
252,Fit & Vital,2068,3948462,90.3528911,
253,Süßspeise,2036,3950498,90.39948101,
254,BLS Spezial,2022,3952520,90.44575056,
255,MA(h)l mit Fleisch,2020,3954540,90.49197434,
256,Vollkornbrötchen,2010,3956550,90.53796929,
257,Ofenkartoffel,1989,3958539,90.58348369,
258,Hauptbeilage,1983,3960522,90.6288608,
259,Mittag 1,1980,3962502,90.67416926,
260,OMeGa-Suppenbar,1976,3964478,90.71938618,
261,HEIMSPIEL,1928,3966406,90.76350472,
262,Nudeltheke,1913,3968319,90.80728002,
263,Gemüsegarten,1912,3970231,90.85103243,
264,Bistro - Bistro,1901,3972132,90.89453312,
265,Pottkieker,1898,3974030,90.93796517,
266,Vegetaria,1885,3975915,90.98109974,
267,Aktionsteller,1884,3977799,91.02421142,
268,Tellergericht II,1879,3979678,91.06720869,
269,Tellergericht I,1873,3981551,91.11006866,
270,Restaurant,1868,3983419,91.15281422,
271,Gut & Günstig 2,1861,3985280,91.19539959,
272,StuBistro Self-Service,1823,3987103,91.23711541,
273,Komplett Menü,1806,3988909,91.27844221,
274,CampusWorld,1793,3990702,91.31947154,
275,Bistro Gourmet Fleisch,1792,3992494,91.36047798,
276,Bistro Gourmet Fisch,1787,3994281,91.40137001,
277,Aktionsessen 3,1774,3996055,91.44196456,
278,Vital Linie,1772,3997827,91.48251334,
279,Fingerfood,1761,3999588,91.52281041,
280,Mensagarten,1755,4001343,91.56297018,
281,Worldwide,1744,4003087,91.60287823,
282,Tellergericht 2,1739,4004826,91.64267187,
283,Campusteller,1726,4006552,91.68216803,
284,Prima Klima,1724,4008276,91.72161843,
285,Diverses,1687,4009963,91.76022215,
286,MA(h)l vegetarisch,1683,4011646,91.79873434,
287,Salate & Desserts,1682,4013328,91.83722364,
288,"EG Nord, 11.30 - 14.30 Uhr",1680,4015008,91.87566718,
289,Meisterwerk,1677,4016685,91.91404208,
290,Menü III,1673,4018358,91.95232543,
291,CampusSpezial,1648,4020006,91.99003672,
292,Salate und Desserts,1644,4021650,92.02765647,
293,Essen 11,1634,4023284,92.06504739,
294,MA(h)l vegan,1604,4024888,92.10175181,
295,Food Angebot im Café ZessP,1581,4026469,92.13792993,
296,Menü 2 vegetarisch,1549,4028018,92.17337579,
297,Menü vegan/vegetarisch,1538,4029556,92.20856993,
298,Late Lunch vegetarisch,1526,4031082,92.24348948,
299,Late Lunch,1511,4032593,92.27806579,
300,Schwein Fisch,1510,4034103,92.31261921,
301,Info,1509,4035612,92.34714974,
302,Wok & Pfanne,1501,4037113,92.38149722,
303,Beilagen ,1483,4038596,92.41543279,
304,Cafeteria Tagesgericht,1466,4040062,92.44897936,
305,Food Angebot im Café Mittelweg,1464,4041526,92.48248016,
306,WOK-Pfanne,1451,4042977,92.51568348,
307,Tagesangebot 1,1437,4044414,92.54856643,
308,QUERBEET,1435,4045849,92.58140362,
309,Pasta- und Gemüsetheke,1422,4047271,92.61394333,
310,Kleine Theke,1419,4048690,92.6464144,
311,Tagesangebot 8,1415,4050105,92.67879393,
312,Beilagen: Suppen,1405,4051510,92.71094462,
313,Information,1389,4052899,92.74272919,
314,Theke,1387,4054286,92.774468,
315,Beilage 4,1386,4055672,92.80618392,
316,"Pfanne, Wok & Co.",1368,4057040,92.83748794,
317,Beilagen: Dessert,1368,4058408,92.86879197,
318,Tagesaktion 1,1359,4059767,92.89989005,
319,Linie 5,1352,4061119,92.93082794,
320,Tagesmenü vegetarisch,1346,4062465,92.96162854,
321,Flammengrill,1345,4063810,92.99240626,
322,Sandwich,1340,4065150,93.02306956,
323,Studitopf,1327,4066477,93.05343538,
324,[pizza]werkPasta,1327,4067804,93.0838012,
325,Gemüsebar,1326,4069130,93.11414413,
326,Links,1326,4070456,93.14448707,
327,Stärkebeilage 1,1312,4071768,93.17450964,
328,CampusVital,1310,4073078,93.20448645,
329, Tagessalat ,1309,4074387,93.23444038,
330,Aktionsessen,1301,4075688,93.26421124,
331,Dessert 2,1297,4076985,93.29389057,
332,Smoothies,1295,4078280,93.32352413,
333,Speiseplan,1292,4079572,93.35308904,
334,Frisches aus Wok und Pfanne,1288,4080860,93.38256242,
335,Mittag 2,1279,4082139,93.41182986,
336,Essen 1 Vegetarisch,1278,4083417,93.44107441,
337, Dessert 2 ,1274,4084691,93.47022742,
338,Tellergericht 1,1270,4085961,93.49928891,
339, Dessert 1 ,1264,4087225,93.5282131,
340,Tagesaktion 2,1264,4088489,93.55713728,
341,Abendgericht,1260,4089749,93.58596994,
342,Abendgericht vegetarisch,1252,4091001,93.61461953,
343,C,1237,4092238,93.64292587,
344,Ofenfrisch,1232,4093470,93.6711178,
345, Gemüsebeilage 1 ,1226,4094696,93.69917243,
346,Essen 1 vegetarisch,1223,4095919,93.72715842,
347,[kœri]werk,1221,4097140,93.75509863,
348,Stamm II,1214,4098354,93.78287867,
349,Veganer renner,1213,4099567,93.81063582,
350, Stärkebeilage 1 ,1210,4100777,93.83832432,
351,Info 1,1197,4101974,93.86571534,
352,Angebot 5,1180,4103154,93.89271735,
353,Große Theke,1163,4104317,93.91933035,
354,Süße Spezial Tagesangebot,1152,4105469,93.94569163,
355,Alternativ,1141,4106610,93.97180121,
356,Food Angebot im Café dell’Arte,1138,4107748,93.99784213,
357,Vegetarische Theke,1138,4108886,94.02388305,
358,Beilagen: Salat,1134,4110020,94.04983244,
359,Stamm I Vegetarisch,1134,4111154,94.07578183,
360,Mensa Klassiker,1128,4112282,94.10159392,
361, Eintopf Mensa ,1120,4113402,94.12722295,
362,kombinierBAR,1115,4114517,94.15273756,
363,Aktionsessen 8,1114,4115631,94.17822929,
364,Nordmensa-Fit,1095,4116726,94.20328624,
365,Tellergericht vegetarisch,1090,4117816,94.22822877,
366,Mensa vital,1086,4118902,94.25307977,
367,Vegetarisch Vegan,1081,4119983,94.27781636,
368,MG Nord 11:30 - 14:15 Uhr,1073,4121056,94.30236988,
369,ESSEN I,1070,4122126,94.32685476,
370,Pasta - 3 Gerichte zur Wahl,1065,4123191,94.35122522,
371,[pizza]werkSalate / Vorspeisen,1056,4124247,94.37538973,
372,[pizza]werkPizza,1044,4125291,94.39927964,
373,Dessert vorport.,1036,4126327,94.42298649,
374,ESSEN II,1034,4127361,94.44664757,
375,Pastatheke,1030,4128391,94.47021713,
376,Pizza I,1030,4129421,94.49378668,
377,Salat-/ Gemüsebuffet 100g,1028,4130449,94.51731046,
378,Bowl,1019,4131468,94.5406283,
379,Pasta I,1018,4132486,94.56392325,
380,Wahlbuffet Salat,1005,4133491,94.58692073,
381,"Snacks, Salate (€/1kg)",1003,4134494,94.60987244,
382,Wahlbuffet Gemüsetheke,1001,4135495,94.63277838,
383,Wahlbuffet Pastatheke,998,4136493,94.65561567,
384,Aktionsessen 2,996,4137489,94.6784072,
385,Beilagen: Warme speisen,996,4138485,94.70119873,
386,Suppe/ Eintopf,988,4139473,94.72380719,
387,Mensa Spezial,984,4140457,94.74632412,
388,Salatbeilage,983,4141440,94.76881817,
389,Klassik,982,4142422,94.79128933,
390, Hauptgericht KM 1 ,975,4143397,94.81360032,
391,Self-Service Grüne Mensa,971,4144368,94.83581977,
392,Attraktiv,969,4145337,94.85799345,
393,Wahlbuffet Schnitzel,968,4146305,94.88014425,
394,Angebot des Tages,966,4147271,94.90224929,
395,Tagsangebot 2,962,4148233,94.92426279,
396,Menü 3 mit drei Beilagen,953,4149186,94.94607035,
397,Heute am Aktionsstand,948,4150134,94.96776349,
398,Tagesaktion .,947,4151081,94.98943375,
399,Veganes Gericht Premium,946,4152027,95.01108112,
400,[pizza]werkPizza11-14 UhrTo-Go,935,4152962,95.03247678,
401,Wochenangebot Kaffeebar,934,4153896,95.05384956,
402,Stamm III,929,4154825,95.07510792,
403,Stärkebeilage 2,925,4155750,95.09627475,
404,Turm 2b,922,4156672,95.11737293,
405,Gabel / Grill,918,4157590,95.13837958,
406,Ökobeilage,916,4158506,95.15934046,
407,Wahlbuffet Dessert,914,4159420,95.18025558,
408,Menüvorschlag / Theke 1 + 6,906,4160326,95.20098763,
409,Burger des Tages,905,4161231,95.2216968,
410,Saison-Angebot,903,4162134,95.2423602,
411,Menüvorschlag,902,4163036,95.26300072,
412,MA(h)l dazu,887,4163923,95.283298,
413,Tagesdessert,883,4164806,95.30350374,
414,Grillteller,882,4165688,95.3236866,
415,Wahlbuffet Wok,871,4166559,95.34361774,
416,[kœri]werk11-14 UhrTo-Go,870,4167429,95.363526,
417,Vegetarisch oder Vegan,864,4168293,95.38329697,
418,WOK 2 - mit Fleisch/Fisch,854,4169147,95.4028391,
419,Abendessen,842,4169989,95.42210664,
420,"Aufläufe, Gratin",840,4170829,95.44132841,
421,Süße Versuchung,839,4171668,95.46052729,
422,Wahlbuffet Gemüsebuffet vegan,837,4172505,95.47968042,
423,Essen 12,830,4173335,95.49867335,
424,Sonderausgabe,828,4174163,95.51762053,
425,Bio - Essen,821,4174984,95.53640752,
426,Menü 2 mit drei Beilagen,820,4175804,95.55517163,
427,Pizzastation,819,4176623,95.57391285,
428,WORLDWIDE,815,4177438,95.59256255,
429,Angebot im GOURMED,806,4178244,95.61100629,
430,Beilage 5,803,4179047,95.62938139,
431,Ökoessen,802,4179849,95.6477336,
432,xXx cafete⁵⁵ xXx,799,4180648,95.66601717,
433,täglich im Angebot,797,4181445,95.68425497,
434,Gemüse ,796,4182241,95.70246988,
435,Kuchen,793,4183034,95.72061615,
436,Mitte,790,4183824,95.73869377,
437, Hauptgericht HK 2 ,790,4184614,95.75677138,
438,Rechts,789,4185403,95.77482612,
439,Tagesangebot 3,779,4186182,95.79265202,
440,Aktionsessen 7,777,4186959,95.81043216,
441,Spätausgabe und Abendessen,770,4187729,95.82805211,
442,Menü 1 mit drei Beilagen,767,4188496,95.84560342,
443,Burger der Woche,764,4189260,95.86308608,
444,Pizza II,763,4190023,95.88054585,
445, Stärkebeilage 2 ,762,4190785,95.89798274,
446,Tellergericht Schnitzel,756,4191541,95.91528234,
447,[pizza]werkPizza11-14 Uhr,755,4192296,95.93255905,
448,...Frühstück...,753,4193049,95.94978999,
449,Gut und Günstig,751,4193800,95.96697517,
450,Gemüsbeilagen,748,4194548,95.9840917,
451,Mittag Ausgabe C2,743,4195291,96.00109381,
452,Salattheke,736,4196027,96.01793574,
453,Mensa Vital,733,4196760,96.03470902,
454,Tagesangebot / Theke 2,731,4197491,96.05143654,
455,[pizza]werk Pizza 11-14 Uhr,727,4198218,96.06807253,
456,Komponente 2,726,4198944,96.08468563,
457,Burger Classic,721,4199665,96.10118431,
458,Mensacafé (Abendessen),720,4200385,96.11766012,
459,Tellergericht 3,718,4201103,96.13409015,
460,xXx Cafeteria StrNa xXx,712,4201815,96.15038289,
461,Abendessen 1,707,4202522,96.16656121,
462,StuBistro Eintopf,706,4203228,96.18271665,
463,Beilagen vorport.,703,4203931,96.19880344,
464,Spezialitätenbuffet,693,4204624,96.21466141,
465,Standard,692,4205316,96.23049648,
466,Abendessen 2,689,4206005,96.24626291,
467,Linie 4,688,4206693,96.26200646,
468,Green Corner,688,4207381,96.27775,
469,CampusCurry,687,4208068,96.29347066,
470,Vollwert  &  Co. Stärke,686,4208754,96.30916844,
471,natürlich fit,685,4209439,96.32484334,
472,Biogericht 2,685,4210124,96.34051823,
473,Al dente,685,4210809,96.35619313,
474,Heiße Theke,684,4211493,96.37184514,
475,mensaVital Vegan,681,4212174,96.3874285,
476,Salatbar,680,4212854,96.40298899,
477,Tellergericht 4,679,4213533,96.41852658,
478,Pasta und Gratins,668,4214201,96.43381247,
479,Med by you,666,4214867,96.44905258,
480,Kartoffeln und Co.,660,4215527,96.4641554,
481,[kœri]werk11-14 Uhr,656,4216183,96.47916669,
482,Beilage 1 ,654,4216837,96.49413221,
483,Menüvorschlag vegetarisch / Theke 1 + 6,653,4217490,96.50907485,
484,Stammessen,650,4218140,96.52394884,
485,Studentenfutter,649,4218789,96.53879994,
486,Fitnesscenter,649,4219438,96.55365105,
487,Turm Vegan Kombi,618,4220056,96.56779278,
488,Menu 2,618,4220674,96.58193451,
489,Gabel,615,4221289,96.59600759,
490,Aktionstheke - WOK/Grill,612,4221901,96.61001203,
491,Classic Express,608,4222509,96.62392493,
492,Tagesangebot - Nur solange der Vorrat reicht,608,4223117,96.63783783,
493,Wahlbuffet Grill,607,4223724,96.65172784,
494,Vital-Linie,607,4224331,96.66561786,
495,Grillgericht I,605,4224936,96.67946211,
496,Turm 3a,604,4225540,96.69328348,
497,Theke 1 - Eintopf,603,4226143,96.70708196,
498,Theke 1 - Vegetarisch,603,4226746,96.72088045,
499,Theke 3 - Empfehlung des Tages,602,4227348,96.73465605,
500,Wahlbuffet Aktionstheke,601,4227949,96.74840877,
501,Cafeteria belegte Brötchen,600,4228549,96.7621386,
502,MG Nord 14:30-21:00,598,4229147,96.77582267,
503,Classic 3,594,4229741,96.78941521,
504,xXx Cafeteria Ring xXx,588,4230329,96.80287045,
505,"Veganes Wochenangebot, pro 100g",587,4230916,96.81630281,
506,Vegetaria**,582,4231498,96.82962075,
507,Tellergericht   ,580,4232078,96.84289292,
508,Salat Büffet,576,4232654,96.85607356,
509,Gourmet,575,4233229,96.86923132,
510,Menü II Vegetaria,570,4233799,96.88227467,
511,Front Cooking/ Wok,570,4234369,96.89531801,
512,WOK/Grill,563,4234932,96.90820117,
513,Beilagenbuffet,555,4235487,96.92090127,
514,Schwein Geflügel,544,4236031,96.93334966,
515,WOK 1 - vegan,544,4236575,96.94579804,
516,Aktion Lahnberge,540,4237115,96.95815489,
517,Frontcooking,540,4237655,96.97051175,
518,Leichte Küche,537,4238192,96.98279995,
519,Menu 3,536,4238728,96.99506527,
520,Schnitzel- Woche,536,4239264,97.00733059,
521,Turm vegetarisch,531,4239795,97.01948149,
522,Salatbuffet / Theke 3,530,4240325,97.03160951,
523,Regionale Linie,524,4240849,97.04360024,
524,Dauer-Spezial,524,4241373,97.05559096,
525,Fleischlos Abend,523,4241896,97.0675588,
526,Fleischgericht Abend,521,4242417,97.07948087,
527,Vollwert  &  Co. Gemüse,519,4242936,97.09135718,
528,xXx Cafeteria SB xXx,516,4243452,97.10316484,
529,Hinweis,515,4243967,97.11494962,
530,Grüne Mensa,515,4244482,97.12673439,
531,Linie 1To-Go,512,4244994,97.13845052,
532,WICHTIG,512,4245506,97.15016665,
533,Essen I Drehkreuz/Ampel,509,4246015,97.16181412,
534,Spaghetteria Spaghetteria,509,4246524,97.1734616,
535,Essen Mittagsmensa Bu,508,4247032,97.18508619,
536, Dessert 3 ,505,4247537,97.19664214,
537,Essen II Drehkreuz/Ampel,504,4248041,97.2081752,
538,Turm vegetarisch Kombi,500,4248541,97.21961673,
539,Abend,498,4249039,97.2310125,
540,Linie 1Gut & Günstig,498,4249537,97.24240826,
541,Baustellenteller,496,4250033,97.25375826,
542,fertig 2,494,4250527,97.26506249,
543,Grillgericht II,490,4251017,97.27627519,
544,Beilagen Mensen,489,4251506,97.287465,
545,[kœri]werk 11-14 Uhr,486,4251992,97.29858617,
546,fertig 1,486,4252478,97.30970734,
547,Last-Minute,481,4252959,97.32071409,
548, Gemüsebeilage 2 ,477,4253436,97.33162931,
549,zzzGemüsebeilagen,476,4253912,97.34252164,
550,Sattmacher,475,4254387,97.3533911,
551,Essen Abendmensa MeCampNo,471,4254858,97.36416902,
552,Geflügel Vegetarisch,469,4255327,97.37490117,
553,Veganes Tagesangebot .,468,4255795,97.38561045,
554,MSC Fisch,465,4256260,97.39625107,
555,Fleisch Und Fisch,465,4256725,97.40689169,
556,Schalter 3: Länder-Mensa,464,4257189,97.41750943,
557,Topf Und Pfanne,464,4257653,97.42812717,
558,Pasta II,459,4258112,97.43863049,
559,Essen III,456,4258568,97.44906517,
560,Komponente 1  ,455,4259023,97.45947696,
561,Tagesmenü vegan,455,4259478,97.46988875,
562,Menüvorschlag vegetarisch,451,4259929,97.48020901,
563,Pasta-Theke,451,4260380,97.49052927,
564,Turm Leichte Küche,439,4260819,97.50057494,
565,Wokgericht,438,4261257,97.51059772,
566,Stärkebeilage 3,433,4261690,97.52050608,
567,Kochtöpfe der Welt,431,4262121,97.53036868,
568,Menu 1,430,4262551,97.5402084,
569,Komponente 3,426,4262977,97.54995658,
570,Tellergericht Everyday,424,4263401,97.559659,
571,Schneller Teller 1,423,4263824,97.56933853,
572,Foodhopper Standort Kaiser-Friedrich-Str. 142,423,4264247,97.57901807,
573,Turm Vegan,419,4264666,97.58860607,
574,Dessert 3,419,4265085,97.59819407,
575,Theke 2 - Gericht mit Fleisch oder Fisch,418,4265503,97.60775919,
576,Cafeteria HeiĂe Theke,417,4265920,97.61730142,
577, Schneller Teller ,409,4266329,97.6266606,
578,Beilagentheke,408,4266737,97.63599688,
579,Fertig 2,407,4267144,97.64531029,
580,Fertig 1,407,4267551,97.65462369,
581,Cafeteria11-14 Uhr,404,4267955,97.66386845,
582,Themenpark,403,4268358,97.67309032,
583,Linie 6,403,4268761,97.6823122,
584,nudelBAR,399,4269160,97.69144254,
585,Komponentenessen,396,4269556,97.70050423,
586,MEISTERWERK | MG Süd Restaurant,392,4269948,97.70947439,
587,Theke links -  (Vegetarisches Gericht),390,4270338,97.71839878,
588,Linie 2To-Go,390,4270728,97.72732317,
589,Theke links und rechts -  (Gericht mit Fleisch oder Fisch),390,4271118,97.73624757,
590,Theke rechts -  (Eintopf/Süßspeise),390,4271508,97.74517196,
591,Tagesessen (vegetarisch),388,4271896,97.75405059,
592,Pfanne,386,4272282,97.76288345,
593,Abend Ausgabe B2,385,4272667,97.77169343,
594, Hauptgericht KM 3 (Aktion) ,385,4273052,97.7805034,
595,Aktionsessen 9,381,4273433,97.78922185,
596,Pasta & Co.,381,4273814,97.7979403,
597,Cafeteria Mittagessen,379,4274193,97.80661298,
598,Low Carb Teller,379,4274572,97.81528565,
599,Essen 01,376,4274948,97.82388969,
600,An der Pizzatheke,374,4275322,97.83244795,
601,MG Nord 11.30 - 14.15 Uhr,371,4275693,97.84093756,
602,"Veganes Wochenangebot,pro 100gSelbstbedienung",369,4276062,97.84938141,
603,Cafeteria11-14 UhrTo-Go,366,4276428,97.85775661,
604,Komponente 1,366,4276794,97.86613181,
605,Schneller Teller 2,365,4277159,97.87448413,
606,Abendessen vegetarisch,364,4277523,97.88281356,
607,Abendkarte (ab 16:00),364,4277887,97.891143,
608,Heiße Theke - Pastabar,363,4278250,97.89944955,
609,Mediterran I,360,4278610,97.90768745,
610,[KĹri]werk,360,4278970,97.91592535,
611,Bayerisch-Schwäbisch I,359,4279329,97.92414037,
612,MG Nord 11:30 - 14:30 Uhr,358,4279687,97.9323325,
613,Essen 13,358,4280045,97.94052464,
614,Dessert's,357,4280402,97.94869389,
615,ab 14:00 Uhr,355,4280757,97.95681738,
616,Cafeteria süß,355,4281112,97.96494086,
617,Fit & Vital Komplettangebot,353,4281465,97.97301858,
618,Pizza III,351,4281816,97.98105054,
619,GRILL,350,4282166,97.98905961,
620,Pasta III,350,4282516,97.99706868,
621,Salat & Dessert I,350,4282866,98.00507775,
622, Hauptgericht KM 2 ,347,4283213,98.01301817,
623,Empore Fleisch,346,4283559,98.02093571,
624,Tagesaktion ..,346,4283905,98.02885325,
625,Tellergericht  ,344,4284249,98.03672502,
626,Grillwurst,344,4284593,98.04459679,
627,Extra an Essen II,343,4284936,98.05244568,
628,QUERBEET | MG Nord 11.30 - 14.15 Uhr,340,4285276,98.06022592,
629,MEISTERWERK,335,4285611,98.06789175,
630,Meal 1,334,4285945,98.07553469,
631,Meal 2,334,4286279,98.08317763,
632,Nachschub-Essen,334,4286613,98.09082058,
633,Vegetarian counter,333,4286946,98.09844063,
634,"Pan, Wok & Co.",327,4287273,98.10592339,
635,Linie 1 Gut & Günstig,324,4287597,98.11333751,
636,Mittagsangebot Cafeteria,324,4287921,98.12075162,
637,Ausgabe rechts,323,4288244,98.12814285,
638,Ausgabe links,322,4288566,98.13551119,
639,Süß & Salzig,322,4288888,98.14287954,
640,Menü Vegetarisch,321,4289209,98.150225,
641,Cafeteria 11-14 Uhr,321,4289530,98.15757046,
642,"Tagessuppe 1,00 Euro",319,4289849,98.16487016,
643,Ausgabe Mitte,319,4290168,98.17216985,
644,Mittag Ausgabe D2,318,4290486,98.17944666,
645,Vegan 1,318,4290804,98.18672348,
646,Gericht 2,317,4291121,98.19397741,
647,Saucen,316,4291437,98.20120845,
648,Gericht 1,316,4291753,98.2084395,
649,Vegetarisch Fisch MSC Fisch,315,4292068,98.21564766,
650,EG Süd - 11:30 - 14:30 Uhr Ampelcounter,314,4292382,98.22283295,
651,Schnitzel-/Burgerbar,313,4292695,98.22999534,
652,Mensa kulinarisch,312,4293007,98.23713486,
653,Imbiss 1,311,4293318,98.24425149,
654,Warme Theke,311,4293629,98.25136812,
655,Salat-buffet,309,4293938,98.25843899,
656,Gut & GĂźnstig,309,4294247,98.26550985,
657,"Weekly vegan dish, per 100g",309,4294556,98.27258072,
658,zZz Hinweis zZz,309,4294865,98.27965158,
659,Fleisch/Fisch,307,4295172,98.28667668,
660,Toppings,306,4295478,98.2936789,
661,Pizza 1,303,4295781,98.30061247,
662,Currywurst,303,4296084,98.30754603,
663,Pizza 2,302,4296386,98.31445672,
664,D+E,300,4296686,98.32132163,
665,Wochenangebot,300,4296986,98.32818655,
666,Front-Cooking,299,4297285,98.33502859,
667,Ökogemüse,299,4297584,98.34187062,
668,Mittagsgericht Cafeteria Klinikum (zzgl. 5€ ReBowl-Pfand),298,4297882,98.34868977,
669,Pasta 1,298,4298180,98.35550892,
670,Pizza 3,297,4298477,98.36230519,
671,Pasta 2,297,4298774,98.36910146,
672,Side dishes,297,4299071,98.37589773,
673,"Pasta, soups & co.",296,4299367,98.38267112,
674,Casseroles & Gratins,296,4299663,98.3894445,
675,Schnitzel-/ Burgerbar,292,4299955,98.39612636,
676,Abend Ausgabe D,292,4300247,98.40280821,
677,Bistro Aktionsgericht,290,4300537,98.4094443,
678,Aktionsteller Fisch,290,4300827,98.41608038,
679,Imbiss 7,286,4301113,98.42262494,
680,VEGETARISCH,286,4301399,98.42916949,
681,Snackangebote / Theke 5,285,4301684,98.43569117,
682,Suppe / Eintopf,284,4301968,98.44218995,
683,EXTRA,283,4302251,98.44866586,
684,Suppenangebot vegetarisch,283,4302534,98.45514177,
685,Beilagen SB,282,4302816,98.46159479,
686,Fast Lane,282,4303098,98.46804781,
687,Aktionsteller Vegan,281,4303379,98.47447795,
688,ESSEN 1,281,4303660,98.48090809,
689,WOK Gericht,281,4303941,98.48733823,
690,ESSEN 2,281,4304222,98.49376837,
691,TÄGLICH,281,4304503,98.50019851,
692,Imbiss 2,280,4304783,98.50660577,
693,Beilagen & Co.,280,4305063,98.51301302,
694,Veganes Angebot,279,4305342,98.5193974,
695, EXPRESS MENÜ ,279,4305621,98.52578177,
696,Fraunhofer-Campus,277,4305898,98.53212038,
697,Komponente 2  ,277,4306175,98.53845899,
698,Tipp des Tages,276,4306451,98.54477471,
699,Bioangebot,276,4306727,98.55109043,
700,Grillstation.,275,4307002,98.55738328,
701,Doppelausgabe-1,274,4307276,98.56365323,
702,Salat- und Pastabuffet,273,4307549,98.56990031,
703,Restaurant MG Süd 11.30 - 14.15 Uhr: Frisch aus dem Wok,273,4307822,98.57614739,
704,Wok und Grill,272,4308094,98.58237158,
705,Grill III,270,4308364,98.58855,
706,Pasta pro Portion oder nach Gewicht (pro 100g),270,4308634,98.59472843,
707,Burger Station,270,4308904,98.60090686,
708,Schalter 2: Mensa Spezial,270,4309174,98.60708528,
709,Eintopf 1,269,4309443,98.61324082,
710,Kreuz & Quer,267,4309710,98.6193506,
711,?,266,4309976,98.6254375,
712,Portion Pommes,265,4310241,98.63150151,
713,zZz Dinner⁵⁵ zZz,264,4310505,98.63754263,
714,Grillstation..,256,4310761,98.6434007,
715,Wohnheim Kaiser-Friedrich-Str.142,255,4311016,98.64923588,
716,Ofen,253,4311269,98.65502529,
717,Dessertbeilage,253,4311522,98.66081471,
718,Abend Ausgabe C,250,4311772,98.66653547,
719,Suppenangebot Suppenküche,250,4312022,98.67225624,
720,Aktionsmenü,249,4312271,98.67795412,
721,x Abendessen x,248,4312519,98.68362912,
722,Vegane Linie,246,4312765,98.68925835,
723,Pizza Point,244,4313009,98.69484182,
724,Hipp & Tipp,244,4313253,98.70042528,
725,Pizza Steinofen,243,4313496,98.70598587,
726,Asia-Theke,242,4313738,98.71152357,
727,Allerleitheke,240,4313978,98.7170155,
728,Pizza Steinofen Margherita,240,4314218,98.72250743,
729,Vegetarisch oder Vegan  ,239,4314457,98.72797649,
730,HEIMSPIEL | MG Nord ab 14:30 Uhr,236,4314693,98.73337689,
731,Beliebt & Gern Gegessen,236,4314929,98.73877729,
732,Wochenhit/Pastateller,235,4315164,98.74415481,
733,Pastabuffet,235,4315399,98.74953233,
734,Fish MSC,232,4315631,98.7548412,
735,Beilagen (3 je Menü),231,4315862,98.76012718,
736,Imbiss,231,4316093,98.76541317,
737,Express,231,4316324,98.77069916,
738,Burgergericht,230,4316554,98.77596226,
739,Restaurant MG Süd 11.30 - 14.15 Uhr: Vom Grill,226,4316780,98.78113383,
740,Wok/Grill,225,4317005,98.78628252,
741,QUERBEET | MG Nord 11.30 - 14.30 Uhr,224,4317229,98.79140833,
742,Beilagen Gemüse/Sättigung,224,4317453,98.79653413,
743,"Grill Beilagen 2,50",223,4317676,98.80163705,
744,Tagesmenü 2,223,4317899,98.80673998,
745,Mediterran II,222,4318121,98.81182002,
746,Veggie-Grillwurst,220,4318341,98.81685429,
747,Bayerisch-Schwäbisch II,219,4318560,98.82186568,
748,Nudelbüffet,217,4318777,98.8268313,
749,Fraunhofer Campus,217,4318994,98.83179693,
750,Nudeltheke (Preis pro 100g) Bitte extra Pasta-Teller verwenden,216,4319210,98.83673967,
751,xxX Cafeteria Snack Xxx,215,4319425,98.84165953,
752,Ökodessert,215,4319640,98.84657938,
753,Asia I,215,4319855,98.85149924,
754, Bediensteten-Menü ,214,4320069,98.85639622,
755,Speisenangebot 1,214,4320283,98.86129319,
756,"HEIMSPIEL | EG Nord, 11.30 - 14.30 Uhr",213,4320496,98.86616728,
757,"Asia Beilagen 0,75",212,4320708,98.87101849,
758,"Mediterran Beilagen 0,65",211,4320919,98.87584682,
759,Wochenhit,211,4321130,98.88067514,
760,Pasta am Grill,210,4321340,98.88548058,
761,Auswahlgericht,210,4321550,98.89028603,
762,Grill I,210,4321760,98.89509147,
763,Tagessuppe 1 ,210,4321970,98.89989691,
764,Wahlessen nur To Go,209,4322179,98.90467947,
765,Speisenangebot 2,209,4322388,98.90946203,
766,Schalter 4: Grüne Mensa,209,4322597,98.91424459,
767,RoKo-Menü,208,4322805,98.91900427,
768,Wahlbuffet,208,4323013,98.92376394,
769,Pasta Ii,207,4323220,98.92850074,
770,Aktion 1,207,4323427,98.93323753,
771,Pizza Iii,206,4323633,98.93795144,
772,Pizza Ii,206,4323839,98.94266535,
773, Dessertbeilage CL ,206,4324045,98.94737926,
774, Gemüsebeilage CL ,205,4324250,98.95207029,
775,Essen W,204,4324454,98.95673843,
776,Tagessuppe 2,202,4324656,98.96136081,
777,Cafeteria Süß,201,4324857,98.9659603,
778,Aus Topf und Pfanne,201,4325058,98.9705598,
779,Belegte Brötchen,201,4325259,98.97515929,
780,Salat Special,200,4325459,98.97973591,
781,Heiße Theke - Suppe,198,4325657,98.98426675,
782,Wahlbuffet (3),198,4325855,98.9887976,
783,Gut & GĂźnstig 1,196,4326051,98.99328268,
784,Pizza (1),196,4326247,98.99776776,
785,Foodhopper,196,4326443,99.00225284,
786, Stärkebeilage CL ,196,4326639,99.00673792,
787,Aktionsessen 1,196,4326835,99.011223,
788,Wahlbuffet Wok (vegan),195,4327030,99.01568519,
789,Tagesaktion 3,195,4327225,99.02014739,
790,Grillstation 1,195,4327420,99.02460959,
791,"Hausgemachte Pasta, heute",194,4327614,99.0290489,
792,Rind Vegetarisch,194,4327808,99.03348821,
793,Wok & Grill 1,193,4328001,99.03790464,
794,Steaks am Grill,192,4328193,99.04229819,
795,Bratwurst,192,4328385,99.04669174,
796,Wok & Grill 2,190,4328575,99.05103952,
797,Bio-Menü Alle Menükomponenten auch einzeln erhältlich,190,4328765,99.0553873,
798,Highlight,188,4328953,99.05968932,
799,Foodhopper Stahnsdorfer Straße 140-156,185,4329138,99.06392268,
800,Wurstbeilage,183,4329321,99.06811028,
801,Mensa Asia,182,4329503,99.072275,
802,Pasta Buffet  pro 100g,182,4329685,99.07643972,
803,Salatteller,182,4329867,99.08060443,
804,Aktion der Woche,179,4330046,99.0847005,
805,Gut & GÃ¼nstig,179,4330225,99.08879657,
806,Aktionsschalter Garching,177,4330402,99.09284687,
807,Ofenfrisch mit Foto 1,175,4330577,99.09685141,
808,Tellergericht vegan,175,4330752,99.10085594,
809,Tagesaktion.,174,4330926,99.10483759,
810,Vegetarisch MSC Fisch,173,4331099,99.10879636,
811,"Asia Beilagen 0,65",173,4331272,99.11275513,
812,Komponente 4,173,4331445,99.1167139,
813,Wild,172,4331617,99.12064979,
814,Hamburger,171,4331788,99.12456279,
815,Restaurant MG Süd 11.30-14.15 Uhr: Pizza,171,4331959,99.12847579,
816,Falafel-Teller,171,4332130,99.1323888,
817,Info 2,171,4332301,99.1363018,
818,Pastaria/WOK,170,4332471,99.14019192,
819,Linie 1BOOK A MENSA,170,4332641,99.14408204,
820,Linie 2 Vegane Linie,170,4332811,99.14797216,
821,"Dessert 1,10",170,4332981,99.15186228,
822,Theke 2 - Klassiker,167,4333148,99.15568375,
823,Cafeteria HeiÃŸe Theke,166,4333314,99.15948234,
824,mensaVital vegan,165,4333479,99.16325804,
825,Grillstation 2,165,4333644,99.16703375,
826,Speisenangebot 3,165,4333809,99.17080945,
827,[KÅ“ri]werk,163,4333972,99.17453939,
828,Suppentopf,163,4334135,99.17826933,
829,Dessert vegan,162,4334297,99.18197639,
830,Tierisch,162,4334459,99.18568344,
831,Abendbrot,161,4334620,99.18936762,
832,Hauptgericht 1,160,4334780,99.1930289,
833,Bio-Gericht,160,4334940,99.19669019,
834,Auswahlgericht veget.,159,4335099,99.2003286,
835,Mensa klassisch,159,4335258,99.20396701,
836,"Grill Beilagen 0,75",158,4335416,99.20758253,
837,Menüvorschlag vegetarisch /  Theke 1 + 6,157,4335573,99.21117517,
838,[pizza]werk Salate / Vorspeisen,156,4335729,99.21474493,
839,Tagesgericht Lahnberge,156,4335885,99.21831469,
840,"Bio Dessert 1,20",156,4336041,99.22188444,
841,Biogericht 4,156,4336197,99.2254542,
842,Ofenfrisch mit Foto 2,153,4336350,99.22895531,
843,Pasta (1),153,4336503,99.23245642,
844,Heute am Aktionsstand (WOK) 1,152,4336655,99.23593464,
845,xPastateller,151,4336806,99.23938998,
846, Hauptgericht HK 1 ,151,4336957,99.24284533,
847,Tagesangebot 5,151,4337108,99.24630067,
848,Schöpfgericht,151,4337259,99.24975601,
849,Menükomponente,151,4337410,99.25321135,
850,...Frühstück⁵⁵...,149,4337559,99.25662093,
851,Buffet 3 (Preis pro 100g),149,4337708,99.2600305,
852,Tagesaktion 6,148,4337856,99.2634172,
853,Beilagen Standard A,148,4338004,99.26680389,
854,Schwein Vegetarisch,147,4338151,99.2701677,
855,Pizza vegan,147,4338298,99.27353151,
856, Hauptgerichte ,147,4338445,99.27689532,
857,Angebot des Tages 1,146,4338591,99.28023624,
858,Tagesangebot Cafeteria,145,4338736,99.28355429,
859,Dessert SB,145,4338881,99.28687233,
860,Nudelbuffet,145,4339026,99.29019038,
861,Biogericht 6,144,4339170,99.29348554,
862,Pasta (2),142,4339312,99.29673493,
863,Tagesgericht 2 (Vegetarisch/Vegan),141,4339453,99.29996144,
864,Nudeltheke nach Gewicht (Preis pro 100g) Bitte extra Pasta-Teller verwenden,141,4339594,99.30318795,
865,Pastatheke..,141,4339735,99.30641446,
866,Angebot zum Oktoberfest,140,4339875,99.30961809,
867,Hauptgericht 2,140,4340015,99.31282172,
868,Veggie Spezial,140,4340155,99.31602535,
869,Live Cooking,139,4340294,99.3192061,
870,Pastatheke.,138,4340432,99.32236396,
871,Angebot d. Tages veget.,138,4340570,99.32552182,
872,Burger am Grill,137,4340707,99.3286568,
873,Heiße Theke - Eintopf,137,4340844,99.33179178,
874,"Hausgemachte frische Pasta, heute",137,4340981,99.33492676,
875,Pizza (2),136,4341117,99.33803885,
876,An der Desserttheke,136,4341253,99.34115095,
877,veganes Angebot,135,4341388,99.34424016,
878,Wahlbuffet Tagestipp,134,4341522,99.34730649,
879,Salatbuffet  /  Theke 3,131,4341653,99.35030417,
880,Empore Veggie,131,4341784,99.35330185,
881,Tagesangebot 4,131,4341915,99.35629953,
882,Gemüsebüffet,131,4342046,99.35929722,
883,Essen Mensa feelgood,131,4342177,99.3622949,
884,Heute am Aktionsstand (WOK),130,4342307,99.36526969,
885,Vegetarisches Menü nur To Go,128,4342435,99.36819873,
886,Doppelausgabe-2,127,4342562,99.37110487,
887,Tagesgericht .,127,4342689,99.37401102,
888,Speisenangebot.,127,4342816,99.37691717,
889,Gut & GÃ¼nstig 1,126,4342942,99.37980044,
890,Veganes Angebot - vegane Küche,126,4343068,99.3826837,
891,Grillstation...,125,4343193,99.38554408,
892,"Mediterran Beilagen 0,90",125,4343318,99.38840447,
893,Biogericht 1,124,4343442,99.39124197,
894,Aktionsessen 10,124,4343566,99.39407947,
895,Abend Ausgabe B,124,4343690,99.39691697,
896,Einfachausgabe,124,4343814,99.39975446,
897,Komplettmenü nur To Go,124,4343938,99.40259196,
898,Pfannengericht,122,4344060,99.4053837,
899,Vegetarische Bratwurst,122,4344182,99.40817543,
900,Abendangebot Ausgabe rechts,121,4344303,99.41094428,
901,Abendangebot Ausgabe Mitte,121,4344424,99.41371313,
902,Schneller Teller 1 - Menü,120,4344544,99.4164591,
903,Hauptgericht 4,120,4344664,99.41920507,
904,Schneller Teller 2 - Menü,119,4344783,99.42192815,
905,Burger,118,4344901,99.42462835,
906,Tagesaktion ...,117,4345018,99.42730567,
907,Biogericht 5,116,4345134,99.4299601,
908,Essen 14,115,4345249,99.43259166,
909,Menü vegan,114,4345363,99.43520032,
910,Streetfood,114,4345477,99.43780899,
911,QUERBEET | EG Süd - 11:30 - 14:30 Uhr Ampelcounter,114,4345591,99.44041766,
912,fertig 3,114,4345705,99.44302633,
913,Weihnachtsaktion,114,4345819,99.445635,
914,Pizza (3),114,4345933,99.44824367,
915,Sommersalate,113,4346046,99.45082945,
916,"Grill Beilagen 0,65",113,4346159,99.45341524,
917,Schalter 1: Mensa Spezial,113,4346272,99.45600103,
918,Querbeet Vegan St,113,4346385,99.45858681,
919,Linie 5 To-Go,112,4346497,99.46114971,
920,Grill Wok,111,4346608,99.46368973,
921,Pizza Pasta,111,4346719,99.46622975,
922,Snackangebote  /  Theke 5,111,4346830,99.46876977,
923,Wahlbuffet Tagesgemüse vegan,110,4346940,99.47128691,
924,Tagesgericht ..,109,4347049,99.47378116,
925,Vegetarisch Fisch,109,4347158,99.47627542,
926,Linie 2BOOK A MENSA,108,4347266,99.47874679,
927,Sprinter,107,4347373,99.48119527,
928,BIO Pasta Bistro 36,106,4347479,99.48362088,
929,Mittagessen 1,106,4347585,99.48604648,
930,Pommes (Beilage),104,4347689,99.48842632,
931,Cafeteria Angebot,104,4347793,99.49080616,
932,Vegetarische Menükomponente,102,4347895,99.49314023,
933,Döner,102,4347997,99.4954743,
934,Westend ist geöffnet,99,4348096,99.49773973,
935,Vegan/Vegetarisches Menü,99,4348195,99.50000515,
936,Grilltheke,99,4348294,99.50227057,
937,Vegetarisch 1,97,4348391,99.50449023,
938,StuBistro Gericht 1,95,4348486,99.50666412,
939,Biogericht 3,95,4348581,99.50883801,
940,Pizzatag,94,4348675,99.51098902,
941,Tagesgericht ....,94,4348769,99.51314002,
942,Tagesgericht ...,94,4348863,99.51529103,
943,Steak am Grill,93,4348956,99.51741916,
944,Oktoberfest-Beilagen,93,4349049,99.51954728,
945,Turm 2b Kombi,93,4349142,99.52167541,
946,Ausgabe 1 Mensaessen To-Go an Ausgabe 1 Fleischlose Alternative,93,4349235,99.52380353,
947,Dessert Mensen Preis 1,93,4349328,99.52593166,
948,Ausgabe 1 Mensaessen To-Go an Ausgabe 1,93,4349421,99.52805978,
949,Tagessuppe campus vita,92,4349513,99.53016502,
950,Angebot 6,91,4349604,99.53224738,
951,vegetarisch,91,4349695,99.53432974,
952,Auswahlgericht vegan,90,4349785,99.53638921,
953,Aktionsbeilage Gemüse 3,89,4349874,99.53842581,
954,Mensa klassisch / Theke 1 + 6,89,4349963,99.5404624,
955,Mensa vegetarisch,89,4350052,99.54249899,
956,Vegetarische Kost  ,89,4350141,99.54453558,
957,"Beilagen, Salate, Dessert",88,4350229,99.54654929,
958,Mensa Salat,88,4350317,99.548563,
959,Mensa Buffet,87,4350404,99.55055383,
960,Beilagen Standard B,87,4350491,99.55254465,
961,Wok- Woche,87,4350578,99.55453548,
962,Ökoessen V,85,4350663,99.55648054,
963,Essen 02,85,4350748,99.5584256,
964,Abend Ausgabe A,84,4350832,99.56034778,
965,Beilagen Gem./Sätt./Salat,83,4350915,99.56224707,
966,"Grill Beilagen 0,8",82,4350997,99.56412348,
967,Schnelle Theke,82,4351079,99.56599989,
968,Tellergericht 4 b,82,4351161,99.5678763,
969,Wok mit,81,4351242,99.56972983,
970,Wok ohne,81,4351323,99.57158336,
971,Brat mit,81,4351404,99.57343689,
972,A+B+E,80,4351484,99.57526753,
973,Heute am Aktionsstand (WOK) 2,80,4351564,99.57709818,
974,Pizza & Pasta - Theke,79,4351643,99.57890594,
975,Brat ohne,79,4351722,99.5807137,
976,WORLDWIDE | EG Süd - 11:30 - 14:30 Uhr Ampelcounter,78,4351800,99.58249858,
977,zZz Game Night zZz,78,4351878,99.58428346,
978,StuBistro Gericht 2,77,4351955,99.58604545,
979,Linie 2vegane Linie,77,4352032,99.58780745,
980,Aktion Mensa,77,4352109,99.58956944,
981, Hauptgericht HK 3 (Aktion) ,76,4352185,99.59130856,
982,Antipasti,76,4352261,99.59304767,
983,Vegetarische Kost,76,4352337,99.59478678,
984,QUERBEET | MG Nord ab 14:30 Uhr,76,4352413,99.59652589,
985,Mensa Aktion,76,4352489,99.59826501,
986,Falafel Teller,76,4352565,99.60000412,
987,Tellergericht III,75,4352640,99.60172035,
988,Extra,75,4352715,99.60343658,
989,Komponente 3  ,75,4352790,99.60515281,
990,Fisch-Aktion,74,4352864,99.60684615,
991,Mensa Salat / Theke 3,74,4352938,99.6085395,
992,STUDY&FIT,74,4353012,99.61023285,
993,Geflügel Vegan,74,4353086,99.61192619,
994,Mittagessen 2,73,4353159,99.61359666,
995,Fit &amp; Vital,72,4353231,99.61524424,
996,Mensa vegan,72,4353303,99.61689182,
997,Extratheke,71,4353374,99.61851651,
998,Auszeit Fleisch,71,4353445,99.62014121,
999,Abendmensa 1,71,4353516,99.62176591,
1000,Mediterran,71,4353587,99.62339061,
1001,Gut & GĂźnstig 2,70,4353657,99.62499242,
1002,Grillstation....,70,4353727,99.62659423,
1003,Angebot 7,69,4353796,99.62817317,
1004,Angebot 9,69,4353865,99.6297521,
1005,Vegetarisch oder vegan,69,4353934,99.63133103,
1006,Angebot 11,69,4354003,99.63290996,
1007,Angebot 10,69,4354072,99.63448889,
1008,Angebot 8,69,4354141,99.63606782,
1009,Angebot 12,69,4354210,99.63764675,
1010,Angebot 13,69,4354279,99.63922568,
1011,Spargelaktion,68,4354347,99.64078173,
1012,Abend - Burger-Dinner,67,4354414,99.6423149,
1013,Burger Auszeit,67,4354481,99.64384806,
1014,Oktoberfest-Angebot,66,4354547,99.64535834,
1015,Nordmensa-Fit Kombi,66,4354613,99.64686862,
1016,zzz Pasta-Teller NEU,66,4354679,99.64837891,
1017,Buffet vegetarisch/vegan je 100g,65,4354744,99.64986631,
1018,Auszeit vegan,65,4354809,99.6513537,
1019,Komponente 5,65,4354874,99.6528411,
1020,Fisch am Grill,65,4354939,99.6543285,
1021,Kartoffeltheke,65,4355004,99.6558159,
1022,Aktuelles,65,4355069,99.6573033,
1023,Abend - Get your Bowl,64,4355133,99.65876782,
1024,Restaurant MG Süd 11.30 - 14.15 Uhr: Teppanyaki Grill,64,4355197,99.66023233,
1025,Linie 2Vegane Linie,64,4355261,99.66169685,
1026,Beilagen 1,64,4355325,99.66316136,
1027,xEssen 2,64,4355389,99.66462588,
1028,Vitalmenü,64,4355453,99.66609039,
1029,Vegan 10,63,4355516,99.66753203,
1030,Ausgabe,63,4355579,99.66897366,
1031,Angebot des Tages 2,63,4355642,99.67041529,
1032,Salat- und Pastabar,62,4355704,99.67183404,
1033,"HEIMSPIEL | EG Nord, 11.30 - 14.15 Uhr",62,4355766,99.67325279,
1034,SpĂ¤tausgabe und Abendessen,61,4355827,99.67464866,
1035,Fisch oder Fleisch,60,4355887,99.67602164,
1036,kombinierBar (täglich wechselnd),60,4355947,99.67739463,
1037,xxx Foodautomat xxx,60,4356007,99.67876761,
1038,Heute am Aktionsstand (WOK) .,60,4356067,99.68014059,
1039,Salatbuffet / Salatteller,59,4356126,99.68149069,
1040,WORLDWIDE | MG Nord ab 14:30 Uhr,59,4356185,99.68284079,
1041,Angebot 14,59,4356244,99.6841909,
1042,Wok & Grill 3,59,4356303,99.685541,
1043,SB-Theke,58,4356361,99.68686821,
1044,Abend - Schnitzel satt,58,4356419,99.68819543,
1045,Suppe & Co ,58,4356477,99.68952265,
1046,Aktionsangebot,57,4356534,99.69082698,
1047,Mensa vegetarisch / Theke 1 + 6,56,4356590,99.69210843,
1048,Abendmensa 5,56,4356646,99.69338989,
1049,Hauptkomponente 1,56,4356702,99.69467134,
1050,Abend 1,56,4356758,99.69595279,
1051,Tellergericht Vegan,56,4356814,99.69723424,
1052,Beilagen 2,55,4356869,99.69849281,
1053,Wok am Grill,55,4356924,99.69975138,
1054,Pizza &amp; Pasta - Theke,55,4356979,99.70100994,
1055,HEIMSPIEL | EG Süd - 11:30 - 14:30 Uhr Ampelcounter,54,4357033,99.70224563,
1056,Auszeit Salat,54,4357087,99.70348131,
1057,Cafe,54,4357141,99.704717,
1058,Ausgabe 1 Mensaessen To-Go Fleischlose Alternative,54,4357195,99.70595268,
1059,xEssen 1,54,4357249,99.70718837,
1060,Ausgabe 1 Mensaessen To-Go,54,4357303,99.70842406,
1061,Abendmensa 8,54,4357357,99.70965974,
1062,"Pasta - Buffet, Gratins, Back-kartoffel & Beilagen",53,4357410,99.71087254,
1063,Extra: Crisp Cut Potatoes,53,4357463,99.71208534,
1064,Extra: Potato Wedges,53,4357516,99.71329815,
1065,Veggie: Süßkartoffel Rucola-Burger,53,4357569,99.71451095,
1066,Veggie: Veganer Blumenkohl-Kartoffel-Burger,53,4357622,99.71572375,
1067,Fleisch: Big Steakhouse Burger,53,4357675,99.71693655,
1068,Veggie: Chili con Quinoa-Burger,53,4357728,99.71814936,
1069,Extra: Twister Pommes,53,4357781,99.71936216,
1070,Fleisch: Jäger Burger,53,4357834,99.72057496,
1071,Fleisch: Schwoba Burger,53,4357887,99.72178776,
1072,Fleisch: Steakhouse Burger,53,4357940,99.72300056,
1073,Extra: Rustic Twist,53,4357993,99.72421337,
1074,Veggie: mediterraner Frischkäse-Bruger,53,4358046,99.72542617,
1075,Extra: Fry 'n Dip Pommes,53,4358099,99.72663897,
1076,Fleisch: crunchy Chicken Burger,53,4358152,99.72785177,
1077,Fleisch: Homestyle Burger,53,4358205,99.72906457,
1078,Veggie: Feta Burger,53,4358258,99.73027738,
1079,Abend 2,53,4358311,99.73149018,
1080,Bioessen (DE-ÖKO-006),52,4358363,99.7326801,
1081,Abendmensa 2,52,4358415,99.73387002,
1082,SpÃ¤tausgabe und Abendessen,52,4358467,99.73505994,
1083,Suppenangebot,51,4358518,99.73622697,
1084,Heiße Theke - Süßspeise,51,4358569,99.73739401,
1085,Focaccia Italia,50,4358619,99.73853816,
1086,"Dessert 0,80",50,4358669,99.73968231,
1087,Menü mit Fleisch/Fisch,50,4358719,99.74082647,
1088,Frohe Festtage,50,4358769,99.74197062,
1089,Abend 5,49,4358818,99.74309189,
1090,Rind Vegan,49,4358867,99.74421316,
1091,Heimspiel Sozial,49,4358916,99.74533443,
1092,Cafeteria Angebot von 8:00-16:30 Uhr,49,4358965,99.7464557,
1093,Wahlbuffet (2),49,4359014,99.74757697,
1094,Tagesangebot 6,49,4359063,99.74869824,
1095,Lassi,49,4359112,99.74981951,
1096,Blondie,49,4359161,99.75094078,
1097,Brownie,49,4359210,99.75206205,
1098,Nudelbar,48,4359258,99.75316044,
1099,Winterbowls,48,4359306,99.75425882,
1100,Abend 3,48,4359354,99.75535721,
1101,Burger 2,48,4359402,99.7564556,
1102,mensaVital vegan 2,47,4359449,99.7575311,
1103,Vegane Küche,47,4359496,99.7586066,
1104,Ma(h)l vegan,47,4359543,99.75968211,
1105,MG Nord 11:30 - 15:00 Uhr,47,4359590,99.76075761,
1106,Sommer Baguette,47,4359637,99.76183312,
1107,Spargel,47,4359684,99.76290862,
1108,KoeriWerk,47,4359731,99.76398412,
1109,Hauptkomponente 2,47,4359778,99.76505963,
1110,Tellergericht Grill,47,4359825,99.76613513,
1111,Tellergericht Pizza,46,4359871,99.76718775,
1112,Vegeteran,46,4359917,99.76824037,
1113,Querbeet St,46,4359963,99.76929299,
1114,Heiße Theke Tagestipp,46,4360009,99.77034561,
1115,Fix und Fertig,46,4360055,99.77139824,
1116,Pasta nach Gewicht (pro 100g),46,4360101,99.77245086,
1117,Barley Bowl,46,4360147,99.77350348,
1118,Tellergericht    ,45,4360192,99.77453321,
1119,Mensaessen To-Go,45,4360237,99.77556295,
1120,Mensaessen To-Go Fleischlose Alternative,45,4360282,99.77659269,
1121,Lenzweck Sandwich,45,4360327,99.77762243,
1122,Menüvorschlag vegan,45,4360372,99.77865216,
1123,Menseria,44,4360416,99.77965902,
1124,Gut & GÃ¼nstig 2,44,4360460,99.78066587,
1125,xXx Brunch⁵⁵ xXx,44,4360504,99.78167273,
1126,mensaVital 2,44,4360548,99.78267958,
1127,Ramen,43,4360591,99.78366355,
1128,Komponente 2 pro Portion oder nach Gewicht (pro 100g),43,4360634,99.78464753,
1129,Feiertag,43,4360677,99.7856315,
1130,Abendaktion,43,4360720,99.78661547,
1131,Heimspiel St,43,4360763,99.78759944,
1132,Tellergericht Fleisch,43,4360806,99.78858341,
1133,Tipp,43,4360849,99.78956738,
1134,Abend - Grill-Diner,42,4360891,99.79052847,
1135,Abendmensa 3,41,4360932,99.79146668,
1136,"Abend - Pasta, Pasta",41,4360973,99.79240488,
1137,Leichte Küche Kombi,41,4361014,99.79334309,
1138,Viva la Mexiko,40,4361054,99.79425841,
1139,Menü 1 Tagestipp,40,4361094,99.79517373,
1140,Abendangebot 15:00 - 18:00 Uhr,40,4361134,99.79608906,
1141,Auswahlgericht 2,40,4361174,99.79700438,
1142,Salat B,40,4361214,99.7979197,
1143,Tagesgericht mit 2 Beilagen ...,39,4361253,99.79881214,
1144,mensaVital-Aktion,39,4361292,99.79970458,
1145,Tagesdessert ,39,4361331,99.80059702,
1146,Tagesgericht mit 2 Beilagen .,39,4361370,99.80148946,
1147,Tagesgericht mit 2 Beilagen ..,39,4361409,99.8023819,
1148,Bistro Tagesgericht,39,4361448,99.80327434,
1149,ab 14 Uhr,39,4361487,99.80416678,
1150,Grill - Menü,38,4361525,99.80503633,
1151,Tellergericht 4 c,38,4361563,99.80590589,
1152,Ma(h)l mit Fleisch,38,4361601,99.80677545,
1153,Dessert Mensen Preis 3,38,4361639,99.807645,
1154,Vegan 2,38,4361677,99.80851456,
1155,Wahlbuffet Weihnachtsmarktbuffet,38,4361715,99.80938411,
1156,Tellergericht Veggie,37,4361752,99.81023079,
1157,Grillgericht III,37,4361789,99.81107746,
1158, Mensa Local ,37,4361826,99.81192413,
1159,Wahlbuffet Sommer special,37,4361863,99.81277081,
1160,Beilagen + Desserts,37,4361900,99.81361748,
1161,Cafeteria Pizza StraNa,37,4361937,99.81446415,
1162,Ma(h)l vegetarisch,36,4361973,99.81528794,
1163,Imbiss 3,36,4362009,99.81611173,
1164,Pasta nach Gewicht (Preis pro 100 g)  ,36,4362045,99.81693552,
1165,Worldwide St,36,4362081,99.81775931,
1166,Tellergericht spezial vegan,36,4362117,99.8185831,
1167,Eintopf Einlage,36,4362153,99.81940689,
1168,kombinierBar (wöchentlich wechselnd),36,4362189,99.82023068,
1169,Schalter 2: Grüne Mensa,35,4362224,99.82103159,
1170,Am Grill,35,4362259,99.8218325,
1171,Türkische Woche,35,4362294,99.82263341,
1172,xXx Cafeteria xXx,35,4362329,99.82343431,
1173,Komponente 3 ,35,4362364,99.82423522,
1174,Vegetarisch/Vegan pro Portion oder nach Gewicht (pro 100g),35,4362399,99.82503613,
1175,Eintopf.,34,4362433,99.82581415,
1176,Gemüsegarten ,34,4362467,99.82659217,
1177,HEIMSPIEL | MG Nord 11.30 - 14.15 Uhr,33,4362500,99.82734732,
1178,Heute am Aktionsstand (WOK) ..,33,4362533,99.82810246,
1179,Schnitzel-Burger-Bar,33,4362566,99.8288576,
1180,Abend 4,33,4362599,99.82961274,
1181,Angebot 15,33,4362632,99.83036788,
1182,Wahlbuffet Winterspecial,33,4362665,99.83112302,
1183,Auswahlgericht vegan 2,32,4362697,99.83185528,
1184,Komponente 3 pro Portion oder nach Gewicht (pro 100g),32,4362729,99.83258754,
1185,"Buntes aus unserer Salatwerkstatt, heute",32,4362761,99.83331979,
1186,Abendmensa 4,31,4362792,99.83402917,
1187,veganes Angebot - vegane Küche,31,4362823,99.83473854,
1188,Aktion Erlenring,31,4362854,99.83544792,
1189,MensaVital pro Portion oder nach Gewicht (pro 100g),31,4362885,99.83615729,
1190,"Mediterran Beilagen 0,75",31,4362916,99.83686667,
1191,HEIMSPIEL | MG Nord 11.30 - 14.30 Uhr,31,4362947,99.83757604,
1192,Pasta zur Selbstentnahme,31,4362978,99.83828542,
1193,Linie 4/5 G&G-Gerichte To-Go,30,4363008,99.83897191,
1194,Aufläufe & Suppen,30,4363038,99.8396584,
1195,Ma(h)l dazu,30,4363068,99.84034489,
1196,Empfehlung des Tages - Coca-Cola Kombimenü,30,4363098,99.84103139,
1197,Heiße Theke Wok,30,4363128,99.84171788,
1198,MEISTERWERK | EG Süd - 11:30 - 14:30 Uhr Ampelcounter,30,4363158,99.84240437,
1199,Wok - Menü,30,4363188,99.84309086,
1200,Menü 2 mit drei Beilagen.,30,4363218,99.84377735,
1201,zzzSättigungsbeilagen,29,4363247,99.84444096,
1202,Jubiläumsangebot,29,4363276,99.84510457,
1203,Wahlbuffet Herbst special,29,4363305,99.84576818,
1204,Dessert Mensen Preis 2,29,4363334,99.84643179,
1205,Spätausgabe Abendessen,29,4363363,99.8470954,
1206,Weihnachtsmenü,29,4363392,99.847759,
1207, Stärkebeilage 3 ,29,4363421,99.84842261,
1208,American Way of Life,29,4363450,99.84908622,
1209,Flammkuchen,29,4363479,99.84974983,
1210,Vegetarisch Wild,28,4363507,99.85039056,
1211,-,28,4363535,99.85103128,
1212,Abendmensa 6,28,4363563,99.85167201,
1213,Burger 1,28,4363591,99.85231273,
1214,Angebot 4 in der Cafeteria,28,4363619,99.85295346,
1215,Beilagen 3,28,4363647,99.85359418,
1216,Abend Ausgabe A2,28,4363675,99.85423491,
1217,Abendmensa 7,28,4363703,99.85487564,
1218,"Beilagen, Desserts",28,4363731,99.85551636,
1219,Fisch Vegan,27,4363758,99.8561342,
1220,Wok - mensaVital,27,4363785,99.85675205,
1221,Tellergericht Pasta,27,4363812,99.85736989,
1222,Biogericht 7,27,4363839,99.85798773,
1223, Mensa Global ,27,4363866,99.85860557,
1224,am Grill,27,4363893,99.85922342,
1225,Abendmensa,27,4363920,99.85984126,
1226,Am Wok,27,4363947,99.8604591,
1227,Info 3,26,4363973,99.86105406,
1228,Essen Abendmensa BuFra,26,4363999,99.86164902,
1229,Mensa Eintopf,26,4364025,99.86224398,
1230,zzzVegetarisches Gericht,26,4364051,99.86283894,
1231,Hot Dog,25,4364076,99.86341102,
1232,FoodHopper,25,4364101,99.86398309,
1233,Hausgemachte frische Pasta,25,4364126,99.86455517,
1234,Vegetarisch 2,25,4364151,99.86512725,
1235,Salat Bowl,25,4364176,99.86569932,
1236,Frisch aus dem Wok,25,4364201,99.8662714,
1237,Aktion: Schwein,25,4364226,99.86684348,
1238,Klimateller,25,4364251,99.86741555,
1239,Frische Pasta heute,24,4364275,99.86796475,
1240,In der Cafeteria,24,4364299,99.86851394,
1241,Grillstand vor dem Haus,24,4364323,99.86906313,
1242,Eintopf vegetarisch,24,4364347,99.86961233,
1243, Mensa Fresh ,24,4364371,99.87016152,
1244, Hauptgericht KM 4 ,24,4364395,99.87071071,
1245,Mensa Vital  ,23,4364418,99.87123702,
1246,Abendgericht 1,23,4364441,99.87176333,
1247,Pasta - Menü,23,4364464,99.87228964,
1248,Komponente 2 ,23,4364487,99.87281595,
1249,Grillecke,23,4364510,99.87334227,
1250,xWOK 2 - mitFleisch/Fisch,23,4364533,99.87386858,
1251,Freeflow,23,4364556,99.87439489,
1252,Mensa vegan / Theke 1 + 6,23,4364579,99.8749212,
1253,Turm 2a,22,4364601,99.87542462,
1254,Express-Angebot / Theke 4,22,4364623,99.87592805,
1255,Cafeteria Angebot von 8:00-15:30 Uhr:,22,4364645,99.87643148,
1256,Spargelwoche,22,4364667,99.87693491,
1257,mensaVital vegetarisch,22,4364689,99.87743833,
1258,Salat & Dessert III,21,4364710,99.87791888,
1259,Vegane Aktion ..,21,4364731,99.87839942,
1260,Catch of the day,21,4364752,99.87887997,
1261,Schalter 4: Mensa Spezial,21,4364773,99.87936051,
1262,Frühstücksangebot,21,4364794,99.87984105,
1263,Cafeteria Angebot von 8:00-15:30 Uhr!,21,4364815,99.8803216,
1264,Last-Minute ab 14.30 UHR,21,4364836,99.88080214,
1265,Campus Cooking,21,4364857,99.88128269,
1266,Salat & Dessert II,21,4364878,99.88176323,
1267,Nudeltheke nach Gewicht (Preis pro 100 g),21,4364899,99.88224378,
1268,Menüvorschlag vegetarisch / Theke 1+6,21,4364920,99.88272432,
1269,Bioessen,21,4364941,99.88320486,
1270,Asia II,21,4364962,99.88368541,
1271,Asia III,21,4364983,99.88416595,
1272,aus dem Wok,21,4365004,99.8846465,
1273,Unser Angebot to go,21,4365025,99.88512704,
1274,Tagesaktion...,21,4365046,99.88560759,
1275,Classic 4,21,4365067,99.88608813,
1276,Mensa Vital   ,20,4365087,99.88654579,
1277,Theke 2,20,4365107,99.88700345,
1278,Schönes Wochenende,20,4365127,99.88746111,
1279,zzzHauptkomponente,20,4365147,99.88791877,
1280,Ausgabe 1 Mensaessen To-Go an der Ausgabe 1,20,4365167,99.88837644,
1281,Ausgabe 1 Mensaessen To-Go an der Ausgabe 1 Fleischlose Alternative,20,4365187,99.8888341,
1282,Tellergericht Wok,20,4365207,99.88929176,
1283,Pizza - Menü,20,4365227,99.88974942,
1284,An unserer Aktionstheke,20,4365247,99.89020708,
1285,Aktion Speisesaal,19,4365266,99.89064186,
1286,Fisch Vegan MSC Fisch,19,4365285,99.89107664,
1287,Aktion 2,19,4365304,99.89151141,
1288,Angebot im Foyer,19,4365323,99.89194619,
1289,Essen 15,19,4365342,99.89238097,
1290,am Wok,19,4365361,99.89281575,
1291,sonstiges,19,4365380,99.89325053,
1292,Cafeteria Angebot von 8:00-14:30 Uhr:,19,4365399,99.89368531,
1293,Abendangebot - ab 15.00 Uhr,19,4365418,99.89412008,
1294,Bio Menü,19,4365437,99.89455486,
1295,Eintopf 2,19,4365456,99.89498964,
1296,Hauptkomponente 3,19,4365475,99.89542442,
1297,Eintopf (Tagesangebot),18,4365493,99.89583631,
1298,Menü 2.,18,4365511,99.89624821,
1299,[pizza]werkPizza11:30-13:30 UhrTo-Go,18,4365529,99.8966601,
1300,Tellergericht spezial vegetarisch,18,4365547,99.897072,
1301,Pasta Buffet pro 100g,18,4365565,99.89748389,
1302,"Beilagen, Salatbuffet,",18,4365583,99.89789579,
1303,Lamm,18,4365601,99.89830768,
1304,WOK-Gericht,18,4365619,99.89871958,
1305,Komponente 4  ,18,4365637,99.89913147,
1306,Weihnachtswoche,18,4365655,99.89954337,
1307,Eintopf / Suppen,18,4365673,99.89995526,
1308,Heute am Aktionsstand ,17,4365690,99.90034428,
1309,Cafeteria Angebot von 8:00-15:00 Uhr!,17,4365707,99.90073329,
1310,Angebot d. Tages vegan,17,4365724,99.9011223,
1311,Pastatheke 1,17,4365741,99.90151131,
1312,xSchneller Teller,17,4365758,99.90190032,
1313,Pastasoße,17,4365775,99.90228934,
1314,Spezialmenü,17,4365792,99.90267835,
1315,Aktionsbeilage Stärke 3,17,4365809,99.90306736,
1316,Informationen,17,4365826,99.90345637,
1317,Heute am Aktionsstand (WOK) 3,16,4365842,99.9038225,
1318,Beilage Standard A,16,4365858,99.90418863,
1319,Imbiss 4,16,4365874,99.90455476,
1320,Beilage Pommes,16,4365890,99.90492089,
1321,Gut &amp; Günstig,16,4365906,99.90528702,
1322,Brunchteller,16,4365922,99.90565315,
1323,Cafeteria Angebot StraNa,16,4365938,99.90601927,
1324,NUR KALKULATION!,16,4365954,99.9063854,
1325,mensaVital vegetarisch 2,16,4365970,99.90675153,
1326,Sonderveranstaltungen,16,4365986,99.90711766,
1327,Tellergericht Süßspeise,16,4366002,99.90748379,
1328,Pastatheke 2,16,4366018,99.90784992,
1329,Pinsa,16,4366034,99.90821605,
1330,In unserer Kühlvitrine,16,4366050,99.90858218,
1331,Vegan pro Portion oder nach Gewicht (pro 100g),16,4366066,99.90894831,
1332,Wahlbuffet Asia-buffet,15,4366081,99.90929155,
1333,Weihnachtsessen,15,4366096,99.9096348,
1334,Schalter 1: Bio-Mensa,15,4366111,99.90997804,
1335,Weihnachtswochen,15,4366126,99.91032129,
1336,Menü 2 Hamburger woche,15,4366141,99.91066454,
1337,WM Aktion,15,4366156,99.91100778,
1338,Komponente 1 ,15,4366171,99.91135103,
1339,Wahlbuffet Fischwoche,15,4366186,99.91169427,
1340,Durch Deutschlands Regionen-Heute,15,4366201,99.91203752,
1341,Wahlbuffet Hot dog trifft currywurst,15,4366216,99.91238076,
1342,Pasta nach Gewicht (Preis pro 100 g)   ,15,4366231,99.91272401,
1343,Aktion: Fisch,15,4366246,99.91306726,
1344,Im Erdgeschoss,15,4366261,99.9134105,
1345,Winterbowls 2,15,4366276,99.91375375,
1346,Sonderaktion,15,4366291,99.91409699,
1347,Ökoessen ,15,4366306,99.91444024,
1348,Wahlbuffet Spargelgala,15,4366321,99.91478349,
1349,"Aufläufe, Gratin & Co",15,4366336,99.91512673,
1350,AKTION,14,4366350,99.91544709,
1351,Jubiläumsangebot.,14,4366364,99.91576746,
1352,Heute am Aktionsstand.,14,4366378,99.91608782,
1353,Angebot zur russischen Woche,14,4366392,99.91640818,
1354,Tagesaktion....,14,4366406,99.91672855,
1355,Tagespreis,14,4366420,99.91704891,
1356,Aktion-Weltvegantag,14,4366434,99.91736927,
1357,xVeganes Gericht,14,4366448,99.91768963,
1358,STUDY & FIT,14,4366462,99.91801,
1359,Achtung,14,4366476,99.91833036,
1360,Heute in der Cafeteria!,14,4366490,99.91865072,
1361,MG Nord 11.30 - 14.30 Uhr,14,4366504,99.91897109,
1362,Schnitzel,14,4366518,99.91929145,
1363,Heute unser Pasta-Angebot,14,4366532,99.91961181,
1364,Themenpark Komponeten,14,4366546,99.91993217,
1365,Frische Pasta,13,4366559,99.92022965,
1366,Suppe & Co 1,13,4366572,99.92052713,
1367,Biogericht 8,13,4366585,99.92082461,
1368,Spaghetteria,13,4366598,99.92112209,
1369,In unserer Kühltheke,13,4366611,99.92141957,
1370,Tagesaktion 7,13,4366624,99.92171705,
1371,Nacht der Klänge,13,4366637,99.92201453,
1372,Ausgabe 1 -Poutine- canadian streetfood Fleischlose Alternative,13,4366650,99.92231201,
1373,Tagesangebot 2,13,4366663,99.92260949,
1374,Tagesangebot 7,13,4366676,99.92290697,
1375,Unser Angebot,13,4366689,99.92320445,
1376,Ausgabe 1 -Poutine- canadian streetfood,13,4366702,99.92350193,
1377,Menü 1 mit drei Beilagen.,12,4366714,99.92377653,
1378,Tellergericht spezial,12,4366726,99.92405113,
1379,xXx Salatbar⁵⁵ xXx,12,4366738,99.92432572,
1380,Wok-Gericht,12,4366750,99.92460032,
1381,HEIMSPIEL | MG Nord 11.30 - 15.00 Uhr,12,4366762,99.92487492,
1382,Wok &amp; Grill,12,4366774,99.92514951,
1383,Unser veganes Angebot,12,4366786,99.92542411,
1384,Fraunhofer,12,4366798,99.92569871,
1385,Pasta wahlweise mit,12,4366810,99.9259733,
1386,Aktions-theke,12,4366822,99.9262479,
1387,The good old Germany,12,4366834,99.9265225,
1388,zzz Veganes Gericht NEU,12,4366846,99.92679709,
1389,Vegetarisch Lamm,12,4366858,99.92707169,
1390,Linie 2Gut & Günstig,12,4366870,99.92734629,
1391,Komponente 7,12,4366882,99.92762088,
1392,Fintesscenter,12,4366894,99.92789548,
1393,Cafeteria Süffiges StraNa,12,4366906,99.92817008,
1394,Cafeteria Salatbar StraNa,12,4366918,99.92844467,
1395,Angebot zum Weltvegantag,12,4366930,99.92871927,
1396,Tagesangebot ,12,4366942,99.92899387,
1397," Heute kein Angebot Mensa vital, dafür Ausgabe Asia Theke",12,4366954,99.92926846,
1398,Herbstfestangebot,11,4366965,99.92952018,
1399,Foodsaver-Aktion,11,4366976,99.92977189,
1400,Komponente 2   ,11,4366987,99.9300236,
1401,Weißwurst-Aktion,11,4366998,99.93027532,
1402,"In der Mensa ""Fraunhofer-Campus""",11,4367009,99.93052703,
1403,Aktionswoche Australien,11,4367020,99.93077874,
1404,Bio-Menü Alle Menü kompo-nenten auch einzeln erhältlich,11,4367031,99.93103046,
1405,Aktons-Theke,11,4367042,99.93128217,
1406,Ausgabe 1 Mensaessen-To-Go an der Ausgabe 1,11,4367053,99.93153389,
1407,Suppe &amp; Co,11,4367064,99.9317856,
1408,Aktionswoche Kanada,11,4367075,99.93203731,
1409,Ausgabe 1 Mensaessen-To-Go an der Ausgabe 1 Fleischlose Alternative,11,4367086,99.93228903,
1410,Am Grill auf der Terrasse,11,4367097,99.93254074,
1411,Tagesaktion.....,11,4367108,99.93279245,
1412,La Dolce Vita,11,4367119,99.93304417,
1413,Mensa vegetarisch /  Theke 1 + 6,10,4367129,99.933273,
1414,Ausgabe 2/3,10,4367139,99.93350183,
1415,Rote Theke - (Empfehlung des Tages),10,4367149,99.93373066,
1416,Aktion - Menü,10,4367159,99.93395949,
1417,Grüne Theke - (Vegetarisches Gericht),10,4367169,99.93418832,
1418,Schnitzel Burger,10,4367179,99.93441715,
1419,Schwein MSC Fisch,10,4367189,99.93464598,
1420,Gelbe Theke - (Angebot mit Fleisch oder Fisch),10,4367199,99.93487481,
1421,Aktionsstand ,10,4367209,99.93510364,
1422,Linie 5 Vegane Linie,10,4367219,99.93533247,
1423,Aktion der Woche :,10,4367229,99.9355613,
1424,Aktion ..,10,4367239,99.93579013,
1425,Aktionswoche Streetfood-woche,10,4367249,99.93601897,
1426,Topf und Pfanne,10,4367259,99.9362478,
1427,Fleisch und Fisch,10,4367269,99.93647663,
1428,QUERBEET | MG Nord 11.30 - 15.00 Uhr,10,4367279,99.93670546,
1429,"Grill Beilagen 0,90",10,4367289,99.93693429,
1430,Querbeet Vegan,10,4367299,99.93716312,
1431,Aktionswoche Indische woche,10,4367309,99.93739195,
1432,HEIMSPIEL | EG Nord ab 14:30 Uhr,10,4367319,99.93762078,
1433,Wildwoche,10,4367329,99.93784961,
1434,Aktion:,10,4367339,99.93807844,
1435,Bio-Menü Alle Menü- kompo-nenten auch einzeln erhältlich,10,4367349,99.93830727,
1436,Komponente 2 - vegan,10,4367359,99.9385361,
1437,Brunch '55,10,4367369,99.93876493,
1438,xWOK 1 - vegan,10,4367379,99.93899376,
1439,zzz Fleischgericht NEU,10,4367389,99.93922259,
1440,Cafeteria Angebot 8:00 - 14:30 Uhr,9,4367398,99.93942854,
1441,Cafereria Menü,9,4367407,99.93963449,
1442,zzzPasta-Teller,9,4367416,99.93984044,
1443,Tellergericht 6,9,4367425,99.94004638,
1444,Imbissgericht,9,4367434,99.94025233,
1445,Beilagen Mensen Preis 3,9,4367443,99.94045828,
1446,Offre la casa,9,4367452,99.94066423,
1447,Angebot im ERDGESCHOSS,9,4367461,99.94087017,
1448,Gratin,9,4367470,99.94107612,
1449,Schneller Teller NEU,9,4367479,99.94128207,
1450,Cafeteria Angebot von 8:00-15:00 Uhr,9,4367488,99.94148802,
1451,[kœri]werk11-14:30 Uhr,9,4367497,99.94169396,
1452,Aktuelle Hinweise,9,4367506,99.94189991,
1453,Cafeteria Angebot :,9,4367515,99.94210586,
1454,Foodhopper am IKMZ,9,4367524,99.94231181,
1455,Internationale Woche,9,4367533,99.94251775,
1456,Bio-Beilagen,9,4367542,99.9427237,
1457,Food Hopper,9,4367551,99.94292965,
1458,xWOK 2 Aktion,9,4367560,99.9431356,
1459,Cafeteria von 8:00-14:30 Uhr in der Mensa:,9,4367569,99.94334154,
1460,Veganes Tagesangebot ..,9,4367578,99.94354749,
1461,Cafeteria Angebot von 8:00 -14:30 Uhr :,9,4367587,99.94375344,
1462,Oktoberfest,9,4367596,99.94395939,
1463,Foodtruck,8,4367604,99.94414245,
1464,Tagesangebote,8,4367612,99.94432552,
1465,Speisenangebot2,8,4367620,99.94450858,
1466,Oma kocht vegan,8,4367628,99.94469165,
1467,Menüvorschlag vegan / Theke 1 + 6,8,4367636,99.94487471,
1468,Tagesgericht Empore,8,4367644,99.94505777,
1469,Vegane Aktion .,8,4367652,99.94524084,
1470,Saisonal,8,4367660,99.9454239,
1471,Imbiss 6,8,4367668,99.94560697,
1472,Heute in der Cafeteria:,8,4367676,99.94579003,
1473,Tellergericht Fisch,8,4367684,99.9459731,
1474,Auswahlgericht veget. 2,8,4367692,99.94615616,
1475,AktionsBar,8,4367700,99.94633923,
1476,Cafeteria Anbgebot ab 8:00 Uhr :,8,4367708,99.94652229,
1477,Abend 6,8,4367716,99.94670535,
1478,Cafeteria Angebot ab  8:00 Uhr :,8,4367724,99.94688842,
1479,Komponente 1   ,8,4367732,99.94707148,
1480,Cafeteria Angebot  Mo-Do 08:00 - 15:00 Uhr  Fr        08:00 - 14:30 Uhr,8,4367740,99.94725455,
1481,Pommes frites,8,4367748,99.94743761,
1482,Tellergericht 8,8,4367756,99.94762068,
1483,Vegetarisches aus Wok und Pfanne,8,4367764,99.94780374,
1484,Ausgabe 1 Pfälzer Gericht der Woche,8,4367772,99.94798681,
1485,Ausgabe 1 Pfälzer Gericht der Woche Fleischlose Alternative,8,4367780,99.94816987,
1486,Sommer-Mensa To-Go im Atrium Fleischlose Alternative,8,4367788,99.94835293,
1487,Grill NEU,8,4367796,99.948536,
1488,Sommer-Mensa To-Go im Atrium,8,4367804,99.94871906,
1489,Speisenangebot 2.,8,4367812,99.94890213,
1490,Tellergericht 4 e,8,4367820,99.94908519,
1491,Angebot im Erdgeschoss,8,4367828,99.94926826,
1492,Tellergericht 4++,8,4367836,99.94945132,
1493,Beilagen Mensen Preis 2,7,4367843,99.9496115,
1494,Wahlbuffet Aschermittwoch-buffet,7,4367850,99.94977168,
1495,PRIMA KLIMA,7,4367857,99.94993187,
1496,"Tagessuppe 1,00 €",7,4367864,99.95009205,
1497,SATTMACHER,7,4367871,99.95025223,
1498,Angebot zur Spargelwoche,7,4367878,99.95041241,
1499,Burritos Mexikanisch,7,4367885,99.95057259,
1500,FLEISCH UND FISCH,7,4367892,99.95073277,
1501,Abendessen - Oktoberfest,7,4367899,99.95089295,
1502,Weihnachtsessen TP,7,4367906,99.95105314,
1503,Frühstück,7,4367913,99.95121332,
1504,Menü 2 Tagestipp,7,4367920,99.9513735,
1505,TOPF UND PFANNE,7,4367927,99.95153368,
1506,xmensaVital,7,4367934,99.95169386,
1507,Pasta pro Portion oder nach Gewicht (pro 100g)  ,7,4367941,99.95185404,
1508,Angebot zum Unitag,7,4367948,99.95201422,
1509,Angebot im 2.Obergeschoß,7,4367955,99.95217441,
1510,Tagesaktion 4,7,4367962,99.95233459,
1511,Schneller Teller - Aktion,7,4367969,99.95249477,
1512,Cafeteria Angebot von 8:00-14:30 Uhr!,7,4367976,99.95265495,
1513,Pfanne am Grill,7,4367983,99.95281513,
1514,Grillstation ,7,4367990,99.95297531,
1515,Cafeteria klassisch,7,4367997,99.95313549,
1516,Nachmittagsangebot I,7,4368004,99.95329568,
1517,Tellergericht 2++,7,4368011,99.95345586,
1518,Hausgemachte Pasta,7,4368018,99.95361604,
1519,Grillfest: Krakauer,6,4368024,99.95375334,
1520,Grillfest: Bratwurst,6,4368030,99.95389063,
1521,Cafeteria Snacks,6,4368036,99.95402793,
1522,Aktion zur Spargelwoche,6,4368042,99.95416523,
1523,Essen 16,6,4368048,99.95430253,
1524,Leer,6,4368054,99.95443983,
1525,Grillfest: Putensteak,6,4368060,99.95457713,
1526,Abend - Pizza,6,4368066,99.95471443,
1527,Cordon Bleu,6,4368072,99.95485172,
1528,Speisenangebot 1.,6,4368078,99.95498902,
1529,Ofen - Menü,6,4368084,99.95512632,
1530,Soja Bolognese,6,4368090,99.95526362,
1531,Heute in der Cafeteria Essen 4!,6,4368096,99.95540092,
1532,Angebot 4  in der Cafeteria,6,4368102,99.95553822,
1533,Speisenangebot ,6,4368108,99.95567551,
1534,Abendessen / dinner,6,4368114,99.95581281,
1535," Heute kein Angebot mensaVital, dafür Ausgabe Asia-Theke",6,4368120,99.95595011,
1536,Cafeteria Angebot von 8:00-15:30Uhr:,6,4368126,99.95608741,
1537,[kĹri]werk,6,4368132,99.95622471,
1538,Auszeit fleischlos,6,4368138,99.95636201,
1539,Oktoberfest Menü,6,4368144,99.9564993,
1540,Menü 3 mit drei Beilagen.,6,4368150,99.9566366,
1541,Ausgabe 1 crazy friesday - canadian streetfood,6,4368156,99.9567739,
1542,Grillfest: Schweinesteak,6,4368162,99.9569112,
1543,Campus Cooking - Angebot im Food Truck,6,4368168,99.9570485,
1544,D + E,6,4368174,99.9571858,
1545,Ausgabe 1 crazy friesday - canadian streetfood Fleischlose Alternative,6,4368180,99.95732309,
1546,Wok Gericht,6,4368186,99.95746039,
1547,Frühstück / breakfast,6,4368192,99.95759769,
1548,Grillstand,6,4368198,99.95773499,
1549,Angebot zur Tschechischen Woche,6,4368204,99.95787229,
1550,Aktionsbeilage Stärke 4,6,4368210,99.95800959,
1551,STREETFOOD,6,4368216,99.95814688,
1552,Salat Bar,6,4368222,99.95828418,
1553,Eiweißarm.vollwert. Essen,6,4368228,99.95842148,
1554,Nuggets and Bites,6,4368234,99.95855878,
1555,Akionsessen,6,4368240,99.95869608,
1556,Menü 2 Spargel - das elfenbein der küche,6,4368246,99.95883338,
1557,Komponente 4 - vegetarisch,6,4368252,99.95897067,
1558,WOK-Pfanne Premium NEU,6,4368258,99.95910797,
1559,Vegetaria a,6,4368264,99.95924527,
1560,Fish & Chips,6,4368270,99.95938257,
1561,Rind Geflügel,6,4368276,99.95951987,
1562,Wahlbuffet Weihnachtsmarkt,6,4368282,99.95965717,
1563,Angebot zur Orientalischen Woche,5,4368287,99.95977158,
1564,Aus dem Pizzaofen,5,4368292,99.959886,
1565,Beilagen Abendmensa BuFra,5,4368297,99.96000041,
1566,Coq au vin,5,4368302,99.96011483,
1567,Rustikal,5,4368307,99.96022924,
1568,Herzhaft,5,4368312,99.96034366,
1569,Cafeteria Angebot von 11:00 16:30 Uhr:,5,4368317,99.96045807,
1570,Kulinarischer Jakobsweg,5,4368322,99.96057249,
1571,Rind Schwein Vegan,5,4368327,99.9606869,
1572,Cafeteria Angebot von 8:00-14:30 Uhr !,5,4368332,99.96080132,
1573,Menü 3.,5,4368337,99.96091573,
1574,Schwein Vegan,5,4368342,99.96103015,
1575,Aktionswoche Die ente im eo,5,4368347,99.96114456,
1576,Aktionswoche Erdbeer- und spargelwoche,5,4368352,99.96125898,
1577,Menü 2 Weihnachtsessen,5,4368357,99.9613734,
1578,Menü 2 Schnitzel,5,4368362,99.96148781,
1579,Mensa Snack / Theke 5,5,4368367,99.96160223,
1580,Nudeltheke nach Gewicht (Preis pro 100 g)  ,5,4368372,99.96171664,
1581,Speisenangebot 3.,5,4368377,99.96183106,
1582,Pfannengerichte,5,4368382,99.96194547,
1583,Pasta-Bar,5,4368387,99.96205989,
1584,Abendangebot- ab 15.00 Uhr,5,4368392,99.9621743,
1585,frischer Spargel am Grill,5,4368397,99.96228872,
1586,Summertime @ Poolbar,5,4368402,99.96240313,
1587,Summertime @ Poolbar...,5,4368407,99.96251755,
1588,Aktionsbeilage Gemüse 4,5,4368412,99.96263196,
1589,Schülermenü,5,4368417,99.96274638,
1590,Angebot zur Matjeswoche,5,4368422,99.96286079,
1591,Veganes Gericht NEU,5,4368427,99.96297521,
1592,Adventsmenü,5,4368432,99.96308962,
1593,Info:,5,4368437,99.96320404,
1594,Bio-Menü Alle Menü- komponenten auch einzeln erhältlich,5,4368442,99.96331846,
1595,Komponente 4 ,5,4368447,99.96343287,
1596,X-Mas Spezial am Grill,5,4368452,99.96354729,
1597,Low Carb Aktion,5,4368457,99.9636617,
1598,Desserttheke,5,4368462,99.96377612,
1599,Cafeteria Pfannengericht,5,4368467,99.96389053,
1600,Cafeteria Angebot von 8:00-15:00 Uhr:,5,4368472,99.96400495,
1601,Tellergericht 6+,5,4368477,99.96411936,
1602,Bio - vegeta-risch & Co.,5,4368482,99.96423378,
1603,Angrillen auf der Asia-Terrasse,5,4368487,99.96434819,
1604,American-Week,5,4368492,99.96446261,
1605,xBeliebt & Gern Gegessen,5,4368497,99.96457702,
1606,Mensa Salat  /  Theke 3,5,4368502,99.96469144,
1607,QUERBEET | EG Nord ab 14:30 Uhr,5,4368507,99.96480585,
1608,Menü 1 Fitness-menü,5,4368512,99.96492027,
1609,Summer Bowl,5,4368517,99.96503468,
1610,Fit in den Frühling,5,4368522,99.9651491,
1611,Aktion aus dem Wok,5,4368527,99.96526352,
1612,Menü 1 Oktoberfest,5,4368532,99.96537793,
1613,Shogok,5,4368537,99.96549235,
1614,Oktoberfest-Dessert,5,4368542,99.96560676,
1615,Aktion: Der Markt von,5,4368547,99.96572118,
1616,Angebot zur historischen Woche,5,4368552,99.96583559,
1617,Angebot Cafeteria,5,4368557,99.96595001,
1618,Adyghe- Herzhaftes Eurasien,5,4368562,99.96606442,
1619,Beilage Standard B,5,4368567,99.96617884,
1620,Abend - Mio-Aktion,4,4368571,99.96627037,
1621,Ausgabe 1 crazy friesday -Poutine- canadian streetfood,4,4368575,99.9663619,
1622,Weihnachtsmarkt im UHG,4,4368579,99.96645343,
1623,The Taste of Asia,4,4368583,99.96654497,
1624,zzzGrill,4,4368587,99.9666365,
1625,Cafeteria Menü vegetarisch,4,4368591,99.96672803,
1626,Weihnachtsmarkt in der Halle,4,4368595,99.96681956,
1627,kombinierBar (wöchtenlich wechselnd),4,4368599,99.9669111,
1628,Beilagen+Desserts,4,4368603,99.96700263,
1629,Tagesmneü vegetarisch,4,4368607,99.96709416,
1630,Abendangebot 15:00 - 17:00 Uhr,4,4368611,99.96718569,
1631,Grill - mensaVital,4,4368615,99.96727722,
1632,ZZZ KT,4,4368619,99.96736876,
1633,! Save the date !,4,4368623,99.96746029,
1634,"Mighty Meat ""Fleisch ist mein Gemüse""",4,4368627,99.96755182,
1635,Ausgabe 1 crazy friesday -Poutine- canadian streetfood Fleischlose Alternative,4,4368631,99.96764335,
1636,Komponente 4 - vegan,4,4368635,99.96773489,
1637,Mittag 1 / lunch 1,4,4368639,99.96782642,
1638,Mittag 2 / lunch 2,4,4368643,99.96791795,
1639,Aktionswoche Nachhaltigkeit,4,4368647,99.96800948,
1640,Grillstand - Menü ,4,4368651,99.96810101,
1641,Heiße Theke Schnitzel,4,4368655,99.96819255,
1642,Grillfest: Bauernsalat,4,4368659,99.96828408,
1643,QUERBEET | EG Nord ab 17:30 Uhr,4,4368663,99.96837561,
1644,Filetto Di Manzo,4,4368667,99.96846714,
1645,Campus Curry,4,4368671,99.96855868,
1646,Nueltheke,4,4368675,99.96865021,
1647,Spargel Klassisch am Grill,4,4368679,99.96874174,
1648,fertig 4,4,4368683,99.96883327,
1649,Highlight der Woche,4,4368687,99.96892481,
1650,"Grill Beilagen 2,60",4,4368691,99.96901634,
1651,Hauptkomponente NEU,4,4368695,99.96910787,
1652,Dönerteller,4,4368699,99.9691994,
1653,Angebot zur jüdischen Woche,4,4368703,99.96929093,
1654,Bowls,4,4368707,99.96938247,
1655,Nacht der Klänge Poolbar,4,4368711,99.969474,
1656,Grillfest: Ofenkartoffel,4,4368715,99.96956553,
1657,Nacht der Klänge am Grill,4,4368719,99.96965706,
1658,Cafeteria Angebot von 8:00-15:30:,4,4368723,99.9697486,
1659,Cafetria Angebot von 8:00-15:00 Uhr:,4,4368727,99.96984013,
1660,je Menü 3 mit drei Beilagen Beilagen,4,4368731,99.96993166,
1661,Fisch vom Grill,4,4368735,99.97002319,
1662,Menü 2 Campus cooking vor der hs mensa,4,4368739,99.97011472,
1663,Cafeteria Oktoberfest Menü,4,4368743,99.97020626,
1664,Ausgabe 2 -Poutine- canadian streetfood Fleischlose Alternative,4,4368747,99.97029779,
1665,Veganes Tagesangebot 1,4,4368751,99.97038932,
1666,Koreanische Woche,4,4368755,99.97048085,
1667,Dessert extra,4,4368759,99.97057239,
1668,Erntedankfest,4,4368763,99.97066392,
1669,Speisenangebot0,4,4368767,99.97075545,
1670,Gemüsegarten 1,4,4368771,99.97084698,
1671,Moussaka vegetarisch,4,4368775,99.97093851,
1672,Cafeteria von 8.00 - 15:00 Uhr  in der Mensa :,4,4368779,99.97103005,
1673,Mensa Asia vegan,4,4368783,99.97112158,
1674,Schwein Fisch MSC Fisch,4,4368787,99.97121311,
1675,Essen 4 - Weihnachtsessen,4,4368791,99.97130464,
1676,Abendangebot 15:00 - 18:00,4,4368795,99.97139618,
1677,Aktion: Rind,4,4368799,99.97148771,
1678,Schnitzelwoche,4,4368803,99.97157924,
1679,Big Chicago-Cheese Burger,4,4368807,99.97167077,
1680,Aktion Tandem,4,4368811,99.9717623,
1681,Essen 4-Sächsische Woche,4,4368815,99.97185384,
1682,Französische Woche,4,4368819,99.97194537,
1683,Cafeteria Angebot von 8:00 - 16:30 Uhr:,4,4368823,99.9720369,
1684,Heute in der Cafeteria !,4,4368827,99.97212843,
1685,Cafeteria Angebot von 8:00-14:30Uhr:,4,4368831,99.97221997,
1686,Aktionswoche,4,4368835,99.9723115,
1687,Komplett Menü nur To Go,4,4368839,99.97240303,
1688,Take Away,4,4368843,99.97249456,
1689,Nudelteller,4,4368847,99.97258609,
1690,Aktionswoche Throwback-woche,4,4368851,99.97267763,
1691,Aktionswoche Trendfood-woche,4,4368855,99.97276916,
1692,"  Bio-Kartoffel­rösti­ecken mit Apfel­mark (3)        1,95 € / 3,30 €  ",4,4368859,99.97286069,
1693,Unser Angebot finden Sie im Erdgeschoss,4,4368863,99.97295222,
1694,Essen4,4,4368867,99.97304376,
1695,"Cafeteria Tagesangebot 2,50 Euro",4,4368871,99.97313529,
1696,Tagesgericht 3 (Vegetarisch),4,4368875,99.97322682,
1697,WORLDWIDE | EG Nord ab 14:30 Uhr,4,4368879,99.97331835,
1698,Ausgabe 1 Mensaessen-To-Go in der Mensaria Atrium,4,4368883,99.97340988,
1699,Cafeteria-Angebot,4,4368887,99.97350142,
1700,Ausgabe 1 Mensaessen-To-Go in der Mensaria Atrium Fleischlose Alternative,4,4368891,99.97359295,
1701,Aktion Wok,4,4368895,99.97368448,
1702,Ostfriesische Tage,4,4368899,99.97377601,
1703,www.weoneworld.de,4,4368903,99.97386755,
1704,zzzGemüsebeilage,4,4368907,99.97395908,
1705,Angebot Tschechischer Tag,4,4368911,99.97405061,
1706,Cafeteria vegan,4,4368915,99.97414214,
1707,zzz Fischgericht NEU,4,4368919,99.97423367,
1708,SALATBUFFET,4,4368923,99.97432521,
1709,Battle Vleisch,4,4368927,99.97441674,
1710,Ausgabe 2 -Poutine- canadian streetfood,4,4368931,99.97450827,
1711,"  Kürbis­burger mit Cashew-Aioli und Apfelmus (3,a,h,j,k)        2,60 € / 3,95 €  ",4,4368935,99.9745998,
1712,Angebot zur tschechischen Woche,4,4368939,99.97469134,
1713,Deutschland,3,4368942,99.97475999,
1714,"  Balkan-Pilz­gu­lasch        1,80 € / 3,15 €  ",3,4368945,99.97482863,
1715,Tagesaktion vegan,3,4368948,99.97489728,
1716,"Ausgabe 1 ""Pfälzer Genusswoche"" Fleischlose Alternative",3,4368951,99.97496593,
1717,Ausgabe 2 crazy friesday -Poutine- canadian streetfood,3,4368954,99.97503458,
1718,Mensa Snack /  Theke 5,3,4368957,99.97510323,
1719,Ausgabe 1 Mensaessen-To-Go an Ausgabe 1,3,4368960,99.97517188,
1720,Ausgabe 1 Mensaessen-To-Go an Ausgabe 1 Fleischlose Alternative,3,4368963,99.97524053,
1721,Köche aus Prag in Aktion,3,4368966,99.97530918,
1722,Köstlichkeiten aus Wald & Wiese,3,4368969,99.97537783,
1723,Frühlingshaft verpackt vom Osterhasen,3,4368972,99.97544648,
1724,"Ausgabe 1 ""Pfälzer Genusswoche""",3,4368975,99.97551513,
1725,Pfannengericht am Grill,3,4368978,99.97558378,
1726,Christmas Spezial,3,4368981,99.97565242,
1727,Angebot des Tages 3,3,4368984,99.97572107,
1728,Ausgabe 1 Mensaessen to-go an der Ausgabe 1 Fleischlose Alternative,3,4368987,99.97578972,
1729,Cafeteria vegetarisch,3,4368990,99.97585837,
1730,Ausgabe 1 Mensaessen to-go an der Ausgabe 1,3,4368993,99.97592702,
1731,Ausgabe 2 crazy friesday -Poutine- canadian streetfood Fleischlose Alternative,3,4368996,99.97599567,
1732,Komponente 3   ,3,4368999,99.97606432,
1733,Cheesecake,3,4369002,99.97613297,
1734,Frischer Spargel am Grill,3,4369005,99.97620162,
1735,Pasta pro Portion oder nach Gewicht (pro 100g)   ,3,4369008,99.97627027,
1736,Menü 1 Grill,3,4369011,99.97633892,
1737,Menü 2 Grill,3,4369014,99.97640757,
1738,Heute in der Cafeteria!!,3,4369017,99.97647621,
1739,Scharfer Start,3,4369020,99.97654486,
1740,Bauernfrühstück,3,4369023,99.97661351,
1741,Crunchy Chicken Burger,3,4369026,99.97668216,
1742,Unsere französischen Köche kochen für Sie,3,4369029,99.97675081,
1743,Menü 1 Hamburger woche,3,4369032,99.97681946,
1744,Menü 2 Aktion „fisch und mee(h)r“,3,4369035,99.97688811,
1745,Durch Deutschlands Regionen-Heute aus dem Badischen Land,3,4369038,99.97695676,
1746,WM-Essen,3,4369041,99.97702541,
1747,Cafeteria Angebot von 8:00-15:00 Uhr !,3,4369044,99.97709406,
1748,WOK-Pfanne NEU,3,4369047,99.97716271,
1749,Fischgericht NEU,3,4369050,99.97723136,
1750,Tagesangebot Fisch,3,4369053,99.9773,
1751,Weihnachtsschmaus,3,4369056,99.97736865,
1752,Vegarisch,3,4369059,99.9774373,
1753,Azubi-Tag,3,4369062,99.97750595,
1754,Angebot zum Erntedankfest,3,4369065,99.9775746,
1755,Angebot zur Oktoberfestwoche,3,4369068,99.97764325,
1756,Aktionsgericht Campus-Cooking,3,4369071,99.9777119,
1757,INFO,3,4369074,99.97778055,
1758,Köttbullar,3,4369077,99.9778492,
1759,Karotten-Ingwersuppe mit Kokosmilch,3,4369080,99.97791785,
1760,Vollkornnudelsalat,3,4369083,99.9779865,
1761,Muffin,3,4369086,99.97805515,
1762,Combo Burger + Fries,3,4369089,99.9781238,
1763,Kartoffeln und Co. Gemüse,3,4369092,99.97819244,
1764,Turm 3b,3,4369095,99.97826109,
1765,Sonnenblumen Burger,3,4369098,99.97832974,
1766,Plant Served Burger,3,4369101,99.97839839,
1767,zzzFleischgericht,3,4369104,99.97846704,
1768,Mac & Cheese,3,4369107,99.97853569,
1769,Curry Balls,3,4369110,99.97860434,
1770,zzzVeganes Gericht,3,4369113,99.97867299,
1771,Oktoberfestteller,3,4369116,99.97874164,
1772,Taco Bowl,3,4369119,99.97881029,
1773,Couscous Bowl,3,4369122,99.97887894,
1774,Hirtensandwich,3,4369125,99.97894759,
1775,Garten Pide,3,4369128,99.97901623,
1776,Bayrische Woche,3,4369131,99.97908488,
1777,Bayerische Woche,3,4369134,99.97915353,
1778,Europa zu Gast,3,4369137,99.97922218,
1779,Angaebot 6,3,4369140,99.97929083,
1780,Weihnachtsmenü I,3,4369143,99.97935948,
1781,Pasta Bar,3,4369146,99.97942813,
1782,Cafeteria Angebot          Mo-Do 08:00 - 15:00 Uhr          Fr        08:00 - 14:30 Uhr,3,4369149,99.97949678,
1783,Tagesgericht (Vegetarisch/Vegan),3,4369152,99.97956543,
1784,Vegan MSC Fisch,3,4369155,99.97963408,
1785,Azubitag,3,4369158,99.97970273,
1786,"""Mit AIESEC um die Welt""",3,4369161,99.97977138,
1787,Garnituren,3,4369164,99.97984002,
1788,Angebot zur Griechischen Woche,3,4369167,99.97990867,
1789,Delicious take away #FRITTEN,3,4369170,99.97997732,
1790,Suppenangebot Tagestipp,3,4369173,99.98004597,
1791,Böhmische Aktionstage,3,4369176,99.98011462,
1792,Delicious take away #BUNT&GESUND,3,4369179,99.98018327,
1793,Rind Schwein Geflügel,3,4369182,99.98025192,
1794,Wurstbeilage.,3,4369185,99.98032057,
1795,*Ausverkauft*,3,4369188,99.98038922,
1796,Cafeteria Angebot 8:00 - 15:30 Uhr:,3,4369191,99.98045787,
1797,Mensa am Ring,3,4369194,99.98052652,
1798,Kalte Snacks,3,4369197,99.98059517,
1799,xAktionen OG,3,4369200,99.98066381,
1800,Frisches vom Grill,3,4369203,99.98073246,
1801,Reserviert für Brückenbausymposium,3,4369206,99.98080111,
1802, Hauptgericht HK 4 ,3,4369209,99.98086976,
1803,Angebot Food Hopper,3,4369212,99.98093841,
1804,Empore,3,4369215,99.98100706,
1805,Cafeteria Angebot von 8:00-15:30 Uhr !,3,4369218,99.98107571,
1806,Delicious take away #FRITTEN Fleischlose Alternative,3,4369221,99.98114436,
1807,x Abendessen Mensa X,3,4369224,99.98121301,
1808,Pasta - mensaVital,3,4369227,99.98128166,
1809,"Pizza ""StraNa""",3,4369230,99.98135031,
1810,Pizza ,3,4369233,99.98141896,
1811,ASIA Aktionstage,3,4369236,99.9814876,
1812,Aktionswoche Bärlauchwoche,3,4369239,99.98155625,
1813,Aktionswoche Duck döner,3,4369242,99.9816249,
1814,WokVital,3,4369245,99.98169355,
1815,Aktionsgericht,3,4369248,99.9817622,
1816,Aktion Campus-Cooking,3,4369251,99.98183085,
1817,Suppen/Eintöpfe,3,4369254,99.9818995,
1818,Tschechische Tage,2,4369256,99.98194527,
1819,Spanien,2,4369258,99.98199103,
1820,Burger am Wok,2,4369260,99.9820368,
1821,Cafeteria Herzhaft,2,4369262,99.98208256,
1822,Schweiz,2,4369264,99.98212833,
1823,Frankreich,2,4369266,99.9821741,
1824,zzzFischgericht,2,4369268,99.98221986,
1825,Aktion Tandem heute,2,4369270,99.98226563,
1826,Forum_TOGO,2,4369272,99.98231139,
1827,Hinweis Für Displays,2,4369274,99.98235716,
1828,Cafeteria Menü vegan,2,4369276,99.98240293,
1829,Tellergericht 4 d,2,4369278,99.98244869,
1830,Hinweis 1,2,4369280,99.98249446,
1831,Menüauswahl,2,4369282,99.98254023,
1832,"BEILAGEN, SALATE",2,4369284,99.98258599,
1833,Brötchen-Angebot   08:00-11:00 Uhr,2,4369286,99.98263176,
1834,QUERBEET | MG Nord 11.30 - 14.00 Uhr,2,4369288,99.98267752,
1835,Kombi-Angebot,2,4369290,99.98272329,
1836,Italien,2,4369292,99.98276906,
1837,Dessert 4,2,4369294,99.98281482,
1838,alles frisch - für den kleinen Appetit,2,4369296,99.98286059,
1839,Frische Pasta-Heute,2,4369298,99.98290635,
1840,"Beilagen, Salate",2,4369300,99.98295212,
1841,Tagesgerichte,2,4369302,99.98299789,
1842,Wildaktionsgericht,2,4369304,99.98304365,
1843,Unser Angebot zum Fit & Fun Tag,2,4369306,99.98308942,
1844,"Hühnchen mit Ananas, Pfirsich und knackigem Gemüse in Curry, dazu gebratene Nudeln (Auch vegan möglich",2,4369308,99.98313519,
1845,Ab 14:00 Uhr,2,4369310,99.98318095,
1846,Battle Fleisch,2,4369312,99.98322672,
1847,Tagesangebot- Nur solange der Vorrat reicht,2,4369314,99.98327248,
1848,Das grüne Glück,2,4369316,99.98331825,
1849,zzzHauptkomponenten,2,4369318,99.98336402,
1850,Tag der gesunden Ernährung,2,4369320,99.98340978,
1851,"Cafeteria ""StraNa""",2,4369322,99.98345555,
1852,Aktionstheke B,2,4369324,99.98350131,
1853,Aktionstheke A,2,4369326,99.98354708,
1854,Zum Dessert,2,4369328,99.98359285,
1855,Heiße Theke - Pastatheke,2,4369330,99.98363861,
1856,Essen 4 - Oktoberfest,2,4369332,99.98368438,
1857,Essen 1 - GO-Next,2,4369334,99.98373014,
1858,Essen 1-Sächsische Woche,2,4369336,99.98377591,
1859,Speisenangebot 4,2,4369338,99.98382168,
1860,Cafeteria ,2,4369340,99.98386744,
1861,Aktion Spargel,2,4369342,99.98391321,
1862,Pastasoße wahlweise,2,4369344,99.98395898,
1863,Tagesangebot-Nur solange der Vorrat reicht,2,4369346,99.98400474,
1864,Essen1,2,4369348,99.98405051,
1865,Pizza-Point,2,4369350,99.98409627,
1866,Azubiessen,2,4369352,99.98414204,
1867,Unsere Azubis kochen für Sie,2,4369354,99.98418781,
1868,Angebot in der 1.Etage! Pasta,2,4369356,99.98423357,
1869,Herbstfestangebot im Erdgeschoss,2,4369358,99.98427934,
1870,Nordsee Seelachs Burger,2,4369360,99.9843251,
1871,Chicken Burger,2,4369362,99.98437087,
1872,Welt-Klimatag,2,4369364,99.98441664,
1873,Cafeteria Angebot von 8:00.15:30 Uhr!,2,4369366,99.9844624,
1874,Ofen - mensaVital,2,4369368,99.98450817,
1875,Schneller Teller 3,2,4369370,99.98455393,
1876,Angebot Food - Hopper,2,4369372,99.9845997,
1877,Angebot2,2,4369374,99.98464547,
1878,Terrasse,2,4369376,99.98469123,
1879,Weihnachtsdessert,2,4369378,99.984737,
1880,Terrasse am Grill,2,4369380,99.98478277,
1881,Angebot 2 - Nur solange der Vorrat reicht,2,4369382,99.98482853,
1882,Tagessuppe:,2,4369384,99.9848743,
1883,"Heute kein Angebot mensaVital, dafür Ausgabe Asia-Theke",2,4369386,99.98492006,
1884,Geflügel Fisch,2,4369388,99.98496583,
1885,Delicious take away #BOWL,2,4369390,99.9850116,
1886,Delicious take away #BUNT&GESUND Fleischlose Alternative,2,4369392,99.98505736,
1887,Menü 1 Weihnachtsessen,2,4369394,99.98510313,
1888,Delicious take away #PASTA,2,4369396,99.98514889,
1889,Delicious take away #PASTA Fleischlose Alternative,2,4369398,99.98519466,
1890,Unsere Azubis kochen heute für Sie,2,4369400,99.98524043,
1891,Beilagen Mensen Preis 1,2,4369402,99.98528619,
1892,! StuWe-Night !,2,4369404,99.98533196,
1893,xX cafete⁵⁵ Xx,2,4369406,99.98537772,
1894,Pasta - mensaVital - Menü,2,4369408,99.98542349,
1895,Cafeteria Angebot von 8:00-14:30 Uhr :,2,4369410,99.98546926,
1896,Cafeteria Angebot             Mo-Do 08:00 - 15:00 Uhr             Fr        08:00 - 14:30 Uhr,2,4369412,99.98551502,
1897,Beliebt &amp; Gern Gegessen,2,4369414,99.98556079,
1898,Aktionsstand .,2,4369416,99.98560656,
1899,"Bunte Salatvariation mit geriebenen Käse, gekochtem Ei und gebratene Schnitzelstreifen ( 22,A,A1,C) oder vegetarische Variation mit roter Beete und Maiskloben (9), dazu ein Brötchen( A,A1,A2) und Kräuterdressing (C,G,I,J) Infos",2,4369418,99.98565232,
1900,[pizza]werkPizza11:30-14:30 UhrTo-Go,2,4369420,99.98569809,
1901,Menü 2 ..,2,4369422,99.98574385,
1902,"Kräuterquark mit Butter und Petersilienkartoffeln, dazu Salat",2,4369424,99.98578962,
1903,Cafeteria Bratwurst,2,4369426,99.98583539,
1904,Weihnachtsmenü II,2,4369428,99.98588115,
1905,Angebot für interne Gäste,2,4369430,99.98592692,
1906,Essen w,2,4369432,99.98597268,
1907,Aktionstjheke,2,4369434,99.98601845,
1908,Mensa schließt früher,2,4369436,99.98606422,
1909,Eintopf /( Suppe,2,4369438,99.98610998,
1910,Ökoessen 5,2,4369440,99.98615575,
1911,Essen M1,2,4369442,99.98620152,
1912,Essen M2,2,4369444,99.98624728,
1913,Grillfest: Vegane Tortellini,2,4369446,99.98629305,
1914,Änderungen vorbehalten !,2,4369448,99.98633881,
1915,Kartoffeln und Co. Stärke,2,4369450,99.98638458,
1916,Bio-Gemüse,2,4369452,99.98643035,
1917,Bio-Stärkebeilage,2,4369454,99.98647611,
1918,Pizza .,2,4369456,99.98652188,
1919,Imbiss 5,2,4369458,99.98656764,
1920,Angebot1,2,4369460,99.98661341,
1921,Schnitzelburger,2,4369462,99.98665918,
1922,Angebot  1,2,4369464,99.98670494,
1923,Grillmenü 2,2,4369466,99.98675071,
1924,Nudeltheke von 11.00 - 14.00 Uhr,2,4369468,99.98679647,
1925,Abendangebot-ab 15.00 Uhr,2,4369470,99.98684224,
1926,Wok-Station,2,4369472,99.98688801,
1927,"Seelachsfilet mit Sesamkruste auf Rahmgemüse, dazu Salzkartoffeln (für Vegetarier",2,4369474,99.98693377,
1928,Fish and Chips,2,4369476,99.98697954,
1929,WM Essen-USA,2,4369478,99.98702531,
1930,Cafeteria Angebot von 8:00 -16:30 Uhr,2,4369480,99.98707107,
1931,Wahlbuffet Spargel,2,4369482,99.98711684,
1932,Menü Hamburger woche,2,4369484,99.9871626,
1933,Cafeteria Angebot von 8:00 - 16:30 Uhr :,2,4369486,99.98720837,
1934,Jambalaya,2,4369488,99.98725414,
1935,Saganaki Feta,2,4369490,99.9872999,
1936,Rakott krumpli,2,4369492,99.98734567,
1937,EM Aktion Frankreich,2,4369494,99.98739143,
1938,Tagessupe,2,4369496,99.9874372,
1939,Bacon-Cheese Burger,2,4369498,99.98748297,
1940,Menü 2 Aktionswoche,2,4369500,99.98752873,
1941,Auf der Terrasse,2,4369502,99.9875745,
1942,Vegetarisch Fisch Vegan MSC Fisch,2,4369504,99.98762026,
1943,Speisenangebot3,2,4369506,99.98766603,
1944,Info 4,2,4369508,99.9877118,
1945,"  Gers­toni Kürbis-Curry (a)        1,80 € / 3,15 €  ",2,4369510,99.98775756,
1946,"  Bio-Tortellini (a)       Bio-Tomaten­sauce (f)       1,95 € / 3,30 €  ",2,4369512,99.98780333,
1947,"  Falafel mit Persi­schem Reis, Pinien­kernen und Pfirsich-Tomaten­chutney (3,a,k,m)       2,25 € / 3,60 €  ",2,4369514,99.9878491,
1948,Surf & Turf,2,4369516,99.98789486,
1949,"Putenstreifen mit Ananas, Pfirsich und knackigem Gemüse in Curry, dazu gebratene Nudeln (Auch fleischlos möglich",2,4369518,99.98794063,
1950,"!Ausgabe an einem neuen Ort! Hausgemachte Pasta, heute",2,4369520,99.98798639,
1951,Nudreltheke,2,4369522,99.98803216,
1952,Hausgemachtes Sushi >> Wochenaktion,2,4369524,99.98807793,
1953,Ausgabe 1 Weihnachtsessen,2,4369526,99.98812369,
1954,Ausgabe 1 Weihnachtsessen Fleischlose Alternative,2,4369528,99.98816946,
1955,Grillstation 3,2,4369530,99.98821522,
1956,"  Bohnen-Zuc­chi­ni-Chili mit Voll­kornreis (3)        2,30 € / 3,65 €  ",2,4369532,99.98826099,
1957,"  Grün­kohl-Linsen-Kokos-Pfanne mit Curry­kartoffeln (2,3,a,k)        2,25 € / 3,60 €  ",2,4369534,99.98830676,
1958,Tagesangebot Cafeteria Zebradiele,2,4369536,99.98835252,
1959,"  Bolly­wood-Kartoffel­curry mit Brokkoli und Mohn (1,f)        1,80 € / 3,15 €  ",2,4369538,99.98839829,
1960,"  Tortellini­salat mit klarem Pesto­dressing (2,3,a,e,h,i,k)        2,40 € / 3,75 €  ",2,4369540,99.98844405,
1961,"  Vegane Bulette Berliner Art mit geschmorten Zwiebeln und Äpfeln (f,j)       2,25 € / 3,60 €  ",2,4369542,99.98848982,
1962,"  Auber­ginen im Hafer­f­lo­cken­mantel mit Toma­tensauce und Gemü­se­bulgur (a)       2,30 € / 3,65 €  ",2,4369544,99.98853559,
1963,Pasta wahlweise,2,4369546,99.98858135,
1964,Heute,2,4369548,99.98862712,
1965,"  Gers­toni Bratling mit Möhren (a,f)      Tomatendip       1,50 € / 3,10 €  ",2,4369550,99.98867289,
1966,Pastasoße wahlweise mit,2,4369552,99.98871865,
1967,Unser Angebot To Go,2,4369554,99.98876442,
1968,"  Tagliatelle an Rucola-Nuss­pesto mit Pinien­kernen, dazu eine Grill­tomate (a,h)        2,40 € / 3,75 €  ",2,4369556,99.98881018,
1969,Aktion zum Tschechischen Tag,2,4369558,99.98885595,
1970,"  Falafel-Qui­noa­burger (2,3,5,a,f,m)        2,60 € / 3,95 €  ",2,4369560,99.98890172,
1971,Südamerika,1,4369561,99.9889246,
1972,xGrilltheke,1,4369562,99.98894748,
1973,"Hausgemachte  Pasta, heute",1,4369563,99.98897037,
1974,Land Kolumbien,1,4369564,99.98899325,
1975,Aktionsessen / Tagespreis,1,4369565,99.98901613,
1976,Land Elfenbeinküste,1,4369566,99.98903901,
1977,Cafeteria Angebot von 11:00 14:30 Uhr:,1,4369567,99.9890619,
1978,"An der Ausgabe ""WOK""",1,4369568,99.98908478,
1979,Komponente 5 - vegan,1,4369569,99.98910766,
1980,Cafeteria Angebot  von 8:00-15:00 Uhr,1,4369570,99.98913055,
1981,"Kräuterquark mit Butter, Petersilienkartoffeln und Salat (Leberwurst zum Zukauf",1,4369571,99.98915343,
1982,Land Australien,1,4369572,99.98917631,
1983,Land Japan,1,4369573,99.9891992,
1984,"Azubi in Aktion, heute",1,4369574,99.98922208,
1985,Komponente 6,1,4369575,99.98924496,
1986,"Kräuterquark mit Butter, Petersilienkartoffeln und Salat (Leberwurst extra",1,4369576,99.98926785,
1987,Ausgabe an der kleinen Pastatheke,1,4369577,99.98929073,
1988,Österreich,1,4369578,99.98931361,
1989,Niederlande,1,4369579,99.98933649,
1990,[pizza]werk Pasta,1,4369580,99.98935938,
1991,xSättigungsbeilagen,1,4369581,99.98938226,
1992,Pizza mit Festpreis klein/groß,1,4369582,99.98940514,
1993,"Hausgemachte Pasta, heute Fussili mit Tomaten-Olivenpesto und Mozzarella oder Gouda (vegane Alternative statt Käse",1,4369583,99.98942803,
1994,"Hausgemachte Pasta, heute Amori mit Champignons, Wirsingkohl und Mozarella (vegane Alternative statt Käse",1,4369584,99.98945091,
1995,Abendangebot 2,1,4369585,99.98947379,
1996,Thailand,1,4369586,99.98949668,
1997,Eintopf vegetarisch.,1,4369587,99.98951956,
1998,Cremiger Blattspinat mit Falafelbällchen und Petersilienkartoffeln (oder vegetarisch,1,4369588,99.98954244,
1999,"Hausgemachte Pasta, heute Linguine mit 9-Kräuterpesto (vegan), wahlweise ",1,4369589,99.98956532,
2000,Ausgabe 2 crazy friesday - canadian streetfood,1,4369590,99.98958821,
2001,Ausgabe 1 Mensaessen To-Go an der Ausgabe1,1,4369591,99.98961109,
2002,xGemüsebeilagen,1,4369592,99.98963397,
2003,Ausgabe 1 Mensaessen To-Go an der Ausgabe1 Fleischlose Alternative,1,4369593,99.98965686,
2004,Ausgabe 1 Mensaessen To-Go der Ausgabe 1,1,4369594,99.98967974,
2005,Ausgabe 2 American BBQ Fleischlose Alternative,1,4369595,99.98970262,
2006,Ausgabe 1 Mensaessen To-Go der Ausgabe 1 Fleischlose Alternative,1,4369596,99.98972551,
2007,"Tagessuppe 1,00 â¬",1,4369597,99.98974839,
2008,Ausgabe 2 Weihnachtsessen,1,4369598,99.98977127,
2009,Ausgabe 2 Weihnachtsessen Fleischlose Alternative,1,4369599,99.98979416,
2010,Ausgabe Wok,1,4369600,99.98981704,
2011,Ausgabe Grill,1,4369601,99.98983992,
2012,"Ausgabe am Essen ""fertig 1""",1,4369602,99.9898628,
2013,Foodhopper ab circa 15:00 Uhr auf dem Campusgelände,1,4369603,99.98988569,
2014,"An der Ausgabe ""fertig 1""",1,4369604,99.98990857,
2015,Heute im Foodhopper!!,1,4369605,99.98993145,
2016,Ausgabe 2 American BBQ,1,4369606,99.98995434,
2017,Eintopf vegetarisch 1,1,4369607,99.98997722,
2018,Snack,1,4369608,99.9900001,
2019,Angrgot 2,1,4369609,99.99002299,
2020,Speisenangebot4,1,4369610,99.99004587,
2021,Land England,1,4369611,99.99006875,
2022,Delicious take away #DÖNER Fleischlose Alternative,1,4369612,99.99009164,
2023,Delicious take away #DÖNER,1,4369613,99.99011452,
2024,Delicious take away #BOWL Fleischlose Alternative,1,4369614,99.9901374,
2025,Delicious take away #SÜSSKARTOFFEL Fleischlose Alternative,1,4369615,99.99016028,
2026,Delicious take away #SÜSSKARTOFFEL,1,4369616,99.99018317,
2027,Land Spanien,1,4369617,99.99020605,
2028,Land Niederlande,1,4369618,99.99022893,
2029,Land Chile,1,4369619,99.99025182,
2030,Speisenangebot..,1,4369620,99.9902747,
2031,Pasta nach Gewicht (Preis pro 100 g)    ,1,4369621,99.99029758,
2032,Take Away Kombi-Angebot,1,4369622,99.99032047,
2033,Menü 2 mit drei Beilagen..,1,4369623,99.99034335,
2034,Land Frankreich,1,4369624,99.99036623,
2035,Tagesaktion vegan 1,1,4369625,99.99038911,
2036,Hier in Ihrer Mensa,1,4369626,99.990412,
2037,Ausgabe 1 canadian streetfood,1,4369627,99.99043488,
2038,Pasta / Gemüsebar je 100g,1,4369628,99.99045776,
2039,Ausgabe 1 canadian streetfood Fleischlose Alternative,1,4369629,99.99048065,
2040,Andebot 2,1,4369630,99.99050353,
2041,WOK- Gericht,1,4369631,99.99052641,
2042,Land Argentinien,1,4369632,99.9905493,
2043,Ukraine,1,4369633,99.99057218,
2044,Land Portugal,1,4369634,99.99059506,
2045,Nordirland,1,4369635,99.99061795,
2046,Polen,1,4369636,99.99064083,
2047,Nudelhteke,1,4369637,99.99066371,
2048,Griechenland,1,4369638,99.99068659,
2049,Grill auf der Terrasse,1,4369639,99.99070948,
2050,Veganes Tagesangebot 2,1,4369640,99.99073236,
2051,Delicious take away #CURRY,1,4369641,99.99075524,
2052,Delicious take away #CURRY Fleischlose Alternative,1,4369642,99.99077813,
2053,Terrasse Angebot 1,1,4369643,99.99080101,
2054,Ausgabe 1 Weihnachtsessen To-Go,1,4369644,99.99082389,
2055,Land Mexico,1,4369645,99.99084678,
2056,Veretarisch,1,4369646,99.99086966,
2057,Heißgetränke,1,4369647,99.99089254,
2058,Land Brasilien,1,4369648,99.99091543,
2059,Getränke in der Mensa,1,4369649,99.99093831,
2060,Tagesangebot - nur solange der Vorrat reicht,1,4369650,99.99096119,
2061,Heute am Aktionsstand 1,1,4369651,99.99098407,
2062,Speisenangebot1,1,4369652,99.99100696,
2063,Angebot in der Mensa,1,4369653,99.99102984,
2064,Wurstbeilage ,1,4369654,99.99105272,
2065,Ausgabe 1 Weihnachtsessen To-Go Fleischlose Alternative,1,4369655,99.99107561,
2066,Nachmittagsangebot,1,4369656,99.99109849,
2067,Land Deutschland,1,4369657,99.99112137,
2068,Ausgabe 2 Mensaessen To-Go,1,4369658,99.99114426,
2069,Land Ghana,1,4369659,99.99116714,
2070,Ausgabe 2 Mensaessen To-Go Fleischlose Alternative,1,4369660,99.99119002,
2071,Land Kamerun,1,4369661,99.99121291,
2072,Ausgabe 1 Menaessen To-Go Fleischlose Alternative,1,4369662,99.99123579,
2073,Ausgabe 1 Menaessen To-Go,1,4369663,99.99125867,
2074,Mensa / Bohne,1,4369664,99.99128155,
2075,Land Kroatien,1,4369665,99.99130444,
2076,Ausgabe 2 Pfälzer Gericht der Woche Fleischlose Alternative,1,4369666,99.99132732,
2077,Land Schweiz,1,4369667,99.9913502,
2078,Nudeltheke  -  Nur in Griebnitzsee,1,4369668,99.99137309,
2079,Ausgabe 2 Pfälzer Gericht der Woche,1,4369669,99.99139597,
2080,Terrasse Angebot 4,1,4369670,99.99141885,
2081,Terrasse Angebot 3,1,4369671,99.99144174,
2082,Terrasse Angebot 2,1,4369672,99.99146462,
2083,Speisenangebot 2..,1,4369673,99.9914875,
2084,Nachmittagsangebot III,1,4369674,99.99151038,
2085,Kompletttmenü,1,4369675,99.99153327,
2086,"Langos mit Sauerrahm oder Knoblauchöl, wahlweise mit",1,4369676,99.99155615,
2087,Abrissbirne,1,4369677,99.99157903,
2088,Fisch & Chips,1,4369678,99.99160192,
2089,Unser Angebot zum Halbfinale der Fußball-EM,1,4369679,99.9916248,
2090,Pasta - Bio-Essen,1,4369680,99.99164768,
2091,Abendessen - Schnitzel sa,1,4369681,99.99167057,
2092,Abendessen - Get your Bow,1,4369682,99.99169345,
2093,Schneller Teller 3 - Menü,1,4369683,99.99171633,
2094,Aktion .,1,4369684,99.99173922,
2095,Unser Angebot zur Fußball-EM,1,4369685,99.9917621,
2096,Draculas Augen,1,4369686,99.99178498,
2097,Unsere Azubis haben gekocht,1,4369687,99.99180786,
2098,Mausetote Oma,1,4369688,99.99183075,
2099,BBQ-Pumpkin,1,4369689,99.99185363,
2100,Frankensteins Fratze,1,4369690,99.99187651,
2101,Blumenkohlhirn,1,4369691,99.9918994,
2102,1 Langos mit Sauerrahm oder Knoblauchöl; wahlweise mit,1,4369692,99.99192228,
2103,Tierisch + Vegetarisch,1,4369693,99.99194516,
2104,Holiday-Food Spanien,1,4369694,99.99196805,
2105,xXx Cafeteria StraNa xXx,1,4369695,99.99199093,
2106,Holiday-Food Türkei,1,4369696,99.99201381,
2107,Aktionsessen Oktoberfest,1,4369697,99.9920367,
2108,Essen 4 - Oktoberfest TP,1,4369698,99.99205958,
2109,Maurer-Dekoltee,1,4369699,99.99208246,
2110,Aktion-Sächsische Woche,1,4369700,99.99210534,
2111,Unsere Azubis haben für Sie gekocht,1,4369701,99.99212823,
2112,Langos mit Sauerrahm oder Knoblauchöl wahlweise mit,1,4369702,99.99215111,
2113,Osteraktion,1,4369703,99.99217399,
2114,Azubikochtag,1,4369704,99.99219688,
2115,Cheeseburger,1,4369705,99.99221976,
2116,Betonmischer,1,4369706,99.99224264,
2117,Schuttrutsche,1,4369707,99.99226553,
2118,Förderband,1,4369708,99.99228841,
2119,Senfpeitsche,1,4369709,99.99231129,
2120,Baubude,1,4369710,99.99233418,
2121,Rüttelplatte,1,4369711,99.99235706,
2122,x Tagessuppe x,1,4369712,99.99237994,
2123,"Getränke ""StraNa""",1,4369713,99.99240282,
2124,"Salatbar ""StraNa""",1,4369714,99.99242571,
2125,Mörtelkelle,1,4369715,99.99244859,
2126,Baggerschaufel,1,4369716,99.99247147,
2127,Standard Französische woche (siehe aushang vor ort),1,4369717,99.99249436,
2128,Spezialitätenbuffet Französische woche (siehe aushang vor ort),1,4369718,99.99251724,
2129,Aktion GO-Next,1,4369719,99.99254012,
2130,Holiday-Food Italien,1,4369720,99.99256301,
2131,Holiday-Food Elsass,1,4369721,99.99258589,
2132,Holiday-Food Südtirol,1,4369722,99.99260877,
2133,Tagesgericht - Nur solange der Vorrat reicht,1,4369723,99.99263165,
2134,Mittag / lunch 1,1,4369724,99.99265454,
2135,In der Mensa (Halle10) 8.00-14.30Uhr,1,4369725,99.99267742,
2136,In der Kaffeebar HaSi (Halle17) 9.30-16.30Uhr,1,4369726,99.9927003,
2137,Tagesgericht - So lange der Vorrat reicht!,1,4369727,99.99272319,
2138,Tagesgericht - Solanger der Vorrat reicht,1,4369728,99.99274607,
2139,Tagesangebot - Nur so langer Vorrat reicht,1,4369729,99.99276895,
2140,Gnocchiauflauf,1,4369730,99.99279184,
2141,Campus Cooking Vive la France,1,4369731,99.99281472,
2142,Pasta mit,1,4369732,99.9928376,
2143,"Entenbruststreifen auf Wokgemüse, dazu gebratene Mie Nudeln (Auch fleischlos möglich",1,4369733,99.99286049,
2144,"Hühnchen mit Ananas, Pfirsich und knackigem Gemüse in Curry, dazu gebratene Nudeln (Auch fleischlos möglich",1,4369734,99.99288337,
2145,"Aprikosen-Quarkauflauf mit Kirschen, dazu Porree-Apfelsalat mit gerösteten Sonnenblumenkernen (Auflauf klein",1,4369735,99.99290625,
2146,Thai-Geflügelhackbällchen auf Wokgemüse mit Mango-Currysoße und Basmati Reis (Auch vegetarisch möglich,1,4369736,99.99292913,
2147,"Bayerisch-Schwäbisch Beilagen 0,75",1,4369737,99.99295202,
2148,"Putenbrust im Backteig auf buntem Gemüse aus dem Wok, dazu gebratene Nudeln oder Basmati Reis (Auch fleischlos möglich",1,4369738,99.9929749,
2149,Putenbrust im Backteig mit Wokgemüse und Mie Nudeln (Vegan möglich,1,4369739,99.99299778,
2150,"Putencurry mit Apfel und Kürbis, dazu gebratene Mie Nudeln (Vegetarisch",1,4369740,99.99302067,
2151,"Entenbruststreifen Soja-Pflaume mit Bohnensprossen, Karotten, Kaiserschoten und Broccoli, dazu Reis (Auch vegan möglich",1,4369741,99.99304355,
2152,Reis (Beilage),1,4369742,99.99306643,
2153,Mittag / lunch 2,1,4369743,99.99308932,
2154,Angebot  2,1,4369744,99.9931122,
2155,"Gebratenes Pangasiusfilet mit Polentakruste, dazu Gemüsekartoffeln und Zitronen-Pfeffer-Dip (alternativ",1,4369745,99.99313508,
2156,Angebot 3 - Nur solange der Vorrat reicht,1,4369746,99.99315797,
2157,D und E sind beide geöffnet,1,4369747,99.99318085,
2158,Rind Schwein Geflügel Fisch,1,4369748,99.99320373,
2159,Pizza Day,1,4369749,99.99322661,
2160,Aktion: Tipp,1,4369750,99.9932495,
2161,Geflügel Fisch Vegan,1,4369751,99.99327238,
2162,Geflügel Vegetarisch Fisch MSC Fisch,1,4369752,99.99329526,
2163,Azubiaktion,1,4369753,99.99331815,
2164,Rind Geflügel Vegetarisch,1,4369754,99.99334103,
2165,Rind Schwein Vegetarisch,1,4369755,99.99336391,
2166,Lehrlings-Aktion,1,4369756,99.9933868,
2167,zzzSmoothies,1,4369757,99.99340968,
2168,Tagesempfehlung,1,4369758,99.99343256,
2169,Pizza groß,1,4369759,99.99345544,
2170,Brasilien,1,4369760,99.99347833,
2171,England,1,4369761,99.99350121,
2172,USA,1,4369762,99.99352409,
2173,Afrika,1,4369763,99.99354698,
2174,Heisse Theke,1,4369764,99.99356986,
2175,Angebot 1 - Nur solange der Vorrat reicht,1,4369765,99.99359274,
2176,Mittagsangebot1,1,4369766,99.99361563,
2177,Chigago-Bacon-Cheese Burger,1,4369767,99.99363851,
2178,Putenbruststreifen mit asiatischem Gemüse und gebratene Mie Nudeln (Auch fleischlos möglich,1,4369768,99.99366139,
2179,Burrito,1,4369769,99.99368428,
2180,"Kohlroulade in deftiger Bratensoße, dazu Schmorkraut und Petersilienkartoffeln - Barzahlungspreis für Gäste",1,4369770,99.99370716,
2181,"Blumenkohl und Wurzelgemüse in Kräuterrahm mit gerösteten Sonnenblumenkernen, dazu Petersilienkartoffeln",1,4369771,99.99373004,
2182,Züricher Schweinegeschnetzeltes mit Spätzle,1,4369772,99.99375292,
2183,Unser Angebot zum Weltvegantag,1,4369773,99.99377581,
2184,Tagesaktion 5,1,4369774,99.99379869,
2185,"Hausgemachter Kuchen, heute",1,4369775,99.99382157,
2186,vegan 2,1,4369776,99.99384446,
2187,Menü 1.,1,4369777,99.99386734,
2188,Menü 2..,1,4369778,99.99389022,
2189,Rakottkrumpli,1,4369779,99.99391311,
2190,Seelachs Burger,1,4369780,99.99393599,
2191,Das kroatische Nationalgericht,1,4369781,99.99395887,
2192,Menü 1 Aktionswoche,1,4369782,99.99398176,
2193,Cotoletta di pollo aromatzzatio,1,4369783,99.99400464,
2194,Griechischer Grillteller,1,4369784,99.99402752,
2195,"Fischplatte nach ""Sicilia Art""",1,4369785,99.9940504,
2196,Mediterran Burger,1,4369786,99.99407329,
2197,Burritos,1,4369787,99.99409617,
2198,Welt-Vegan-Tag Shogok,1,4369788,99.99411905,
2199,Aphrodite Teller,1,4369789,99.99414194,
2200,Soja-Chiligeschnetzeltes mit Paprikabulgur - Barzahlungspreis für Gäste,1,4369790,99.99416482,
2201,Buffet vegetarisch/vegan,1,4369791,99.9941877,
2202,"Hähnchenkeule California (mit Pfirsich und Tabasco), dazu Buttermais und Kräuterreis - Barzahlungspreis für Gäste",1,4369792,99.99421059,
2203,Angebot für Schülergruppe,1,4369793,99.99423347,
2204,Nachmittagsangebot II,1,4369794,99.99425635,
2205,Aktion III,1,4369795,99.99427924,
2206,Geschlossen,1,4369796,99.99430212,
2207,Essen D,1,4369797,99.994325,
2208,Pasta 3,1,4369798,99.99434788,
2209,Classic S,1,4369799,99.99437077,
2210,Donnerstag - Eintopf / Suppe,1,4369800,99.99439365,
2211,Mensa to go,1,4369801,99.99441653,
2212,Vege- tarisch,1,4369802,99.99443942,
2213,Mensa  Asia,1,4369803,99.9944623,
2214,Angebot Welt Vegan Tag,1,4369804,99.99448518,
2215,Suppen zu Bursepreisen,1,4369805,99.99450807,
2216,Aktion Salat,1,4369806,99.99453095,
2217,Biogericht 9,1,4369807,99.99455383,
2218,Für Schülergruppe,1,4369808,99.99457671,
2219,Vegan 3,1,4369809,99.9945996,
2220,Vegan 4,1,4369810,99.99462248,
2221,Menü 1-VEGAN,1,4369811,99.99464536,
2222,Menü 2-VEGAN,1,4369812,99.99466825,
2223,Moussaka,1,4369813,99.99469113,
2224,Honey-Mustard glazed Ribs Magere,1,4369814,99.99471401,
2225,Big Chicago-Cheese Burger Black Pearl,1,4369815,99.9947369,
2226,Eröffnung der Fußball-WM in Brasilien,1,4369816,99.99475978,
2227,Nudeltheke von 11.00 bis 14.00 Uhr,1,4369817,99.99478266,
2228,Tagesangebot - solange der Vorrat reicht,1,4369818,99.99480555,
2229,Nudelbar von 11.00 bis 14.00 Uhr,1,4369819,99.99482843,
2230,Nudelbar - 11:00 - 14:00 Uhr,1,4369820,99.99485131,
2231,Tagesangebot-solange der Vorrat reicht,1,4369821,99.99487419,
2232,Tagesangebot  Solange der Vorrat reicht,1,4369822,99.99489708,
2233,Tagesangebot - solange drer Vorrat reicht,1,4369823,99.99491996,
2234,In der Mensa Fraunhofer Campus,1,4369824,99.99494284,
2235,Grillmenü 4,1,4369825,99.99496573,
2236,Grillmenü 3,1,4369826,99.99498861,
2237,Grillmenü 1,1,4369827,99.99501149,
2238,zzzWOK-Pfanne Premium,1,4369828,99.99503438,
2239,zzzWOK-Pfanne,1,4369829,99.99505726,
2240,zzzVeganes GerichtPremium,1,4369830,99.99508014,
2241,zzzSchneller Teller,1,4369831,99.99510303,
2242,Vegetarirches Gericht NEU,1,4369832,99.99512591,
2243,Highlight der Woche Hamurger,1,4369833,99.99514879,
2244,"Bunte Salatvariation mit Lollo Rosso, Feldsalat, Möhre, Gurke, Tomate, Paprika und Hähnchenstreifen, dazu Gartenkräuterdressing und Brötchen Vegetarische Alternative",1,4369834,99.99517167,
2245,Highlight der Woche - Von unserer Landfleischerei,1,4369835,99.99519456,
2246,MEER 1,1,4369836,99.99521744,
2247,"ZEITREISE 25 Jahre Studentenwerke, damals gab´s",1,4369837,99.99524032,
2248,EM Aktion Portugal,1,4369838,99.99526321,
2249,Pangasiusfilet Lemmon-Koriander auf hausgemachtem Kartoffelsalat (alternativ vegetarisch,1,4369839,99.99528609,
2250,EM Aktion England,1,4369840,99.99530897,
2251,Chicken Fingers Burger,1,4369841,99.99533186,
2252,^B,1,4369842,99.99535474,
2253,Crispy Seelachs Burger,1,4369843,99.99537762,
2254,Los Angeles Teriyaki Burger,1,4369844,99.99540051,
2255,Mediterraner Burger,1,4369845,99.99542339,
2256,Ranger Potato,1,4369846,99.99544627,
2257,Vital Vegan,1,4369847,99.99546915,
2258,Menü 2 „aktion fisch und mee(h)r“,1,4369848,99.99549204,
2259,Vegetarisch Ausgabe am menü 1,1,4369849,99.99551492,
2260,Jamaika Jerk Chicken,1,4369850,99.9955378,
2261,Menü Ii Vegetaria**,1,4369851,99.99556069,
2262,Menü Iii,1,4369852,99.99558357,
2263,Wok/grill,1,4369853,99.99560645,
2264,Mousaka,1,4369854,99.99562934,
2265,New Yorker Chicken Ramen Burger,1,4369855,99.99565222,
2266,Vegan Vital,1,4369856,99.9956751,
2267,Meisterwerk Aktion,1,4369857,99.99569798,
2268,Querbeet 1,1,4369858,99.99572087,
2269,Hähnchenschnitzel auf Wokgemüse mit Mango-Currysoße und Basmati Reis (Auch fleischlos möglich,1,4369859,99.99574375,
2270,"  Bunte Tortellini mit Tomaten­sauce und geriebenem Hart­käse (1,2,a,c,g,i)  1,80 € / 3,15 €  ",1,4369860,99.99576663,
2271,Vegetarisch TG 4,1,4369861,99.99578952,
2272,Schweden,1,4369862,99.9958124,
2273,Hausgemachte Pasta - Heute,1,4369863,99.99583528,
2274,EM Woche-Kroatien,1,4369864,99.99585817,
2275,EM Woche-England,1,4369865,99.99588105,
2276,EM Woche-Frankreich,1,4369866,99.99590393,
2277,EM Woche-Polen,1,4369867,99.99592682,
2278,EM Woche-Spanien,1,4369868,99.9959497,
2279,Heute im Angebot an der Desserttheke ,1,4369869,99.99597258,
2280,"Mariniertes Lachsfilet auf Wokgemüse , dazu gebratene Mie Nudeln (auch vegan möglich",1,4369870,99.99599546,
2281,Türkei,1,4369871,99.99601835,
2282,letzter Tag am Grill,1,4369872,99.99604123,
2283,"  Winter­li­ches Anti­pas­ti­ge­müse (3,k)       Basi­li­k­umdip (f,j)      2,40 € / 3,75 €  ",1,4369873,99.99606411,
2284,Ferien vom 23.12.2017 bis 01.01.2018,1,4369874,99.996087,
2285,"Gebratene Schweinemedaillons auf buntem Wokgemüse, dazu Kokosreis (Auch fleischlos möglich",1,4369875,99.99610988,
2286,"Im Tempurateig frittierte Hähnchenbrust auf buntem Gemüse aus dem Wok, dazu Basmati Reis (Auch vegan möglich",1,4369876,99.99613276,
2287,"Rindergulasch mit Preiselbeeren, Sauerkirschen und grünem Pfeffer, dazu Prinzessbohnen, Hefeknödel oder Kartoffelklöße ODER Jägerschnitzel (panierte Jagdwurst) mit Tomatensoße und Petersilienkartoffeln, dazu Salat",1,4369877,99.99615565,
2288,Cafeteria Info,1,4369878,99.99617853,
2289,Extra am Grill,1,4369879,99.99620141,
2290,Hausgemachte Pasta am Grill,1,4369880,99.9962243,
2291,Weihnachtsmarkt...,1,4369881,99.99624718,
2292,Frohe Weihnachten und einen guten Rutsch...,1,4369882,99.99627006,
2293,Tag der offenen Tür,1,4369883,99.99629294,
2294,Geänderte Öffnungzeit,1,4369884,99.99631583,
2295,Hähnchen im Backteig auf gebratenen Mie Nudeln (Auch fleischlos möglich,1,4369885,99.99633871,
2296,Gebratene Entenbruststreifen auf buntem Wokgemüse mit gebratenen Mie Nudeln (Auch vegetarisch  möglich,1,4369886,99.99636159,
2297,"  Soja­sch­netzel Tikka Masala (3,f,j,m)        2,00 € / 3,60 €  ",1,4369887,99.99638448,
2298,"  Kartof­fel­rollis Toma­te-Moz­za­rella (g)      Oliven­c­reme (f,j)      1,80 € / 3,40 €  ",1,4369888,99.99640736,
2299,"  Gemü­se­paella mit Voll­kornreis und Walnüssen (2,a,f,h,m)        2,40 € / 3,75 €  ",1,4369889,99.99643024,
2300,"  Brat­nu­delp­fanne mit Asia­ge­müse (2,a,f,m)      Red Thaidip (2,3,5)      1,60 € / 2,95 €  ",1,4369890,99.99645313,
2301,"  Pilz-Stro­ganoff mit Gemü­se-Pilaw (2,9,f,i)        1,80 € / 3,15 €  ",1,4369891,99.99647601,
2302,"  Kicher­erb­sen-Hir­sep­fanne       Minz­c­re­medip (3,f)       1,80 € / 3,15 €  ",1,4369892,99.99649889,
2303,"  Gebra­tene Thymi­an­kar­tof­feln       Grüne Mojo (f,j)       1,60 € / 2,95 €  ",1,4369893,99.99652177,
2304,"  Bio-Tor­tel­lini mit Sauce Bolog­nese (a)         2,80 € / 4,35 €  ",1,4369894,99.99654466,
2305,"  Gemü­sep­fanne mit Rucola       Papri­kadip (f,j)      1,80 € / 3,15 €  ",1,4369895,99.99656754,
2306,"  Bio-Spag­hetti (a)       Bio-So­ja-Bo­log­nese (f)        1,95 € / 3,30 €  ",1,4369896,99.99659042,
2307,"  Curry Cous­cous mit Pilzen und Zucchini (3,a,f)       Minz­c­re­medip (3,f)       2,40 € / 3,75 €  ",1,4369897,99.99661331,
2308,"  Cannel­loni mit Spinat und Käsesauce (1,2,a,c,g)       -  ",1,4369898,99.99663619,
2309,"Hühnchen mit Ananas, Pfirsich und knackigem Gemüse in Curry, dazu Reis (Auch vegan möglich",1,4369899,99.99665907,
2310,Geänderte Öffnungszeiten,1,4369900,99.99668196,
2311,Tagesmenüs,1,4369901,99.99670484,
2312,"Hähnchen Thai Sweet Chili mit buntem Paprika, Zwiebeln, Sprossen und Zucchini, dazu gebratene Mie Nudeln -Auch vegan möglich",1,4369902,99.99672772,
2313,"Hähnchen Thai Sweet Chili mit buntem Paprika, Zwiebeln, Sprossen und Zucchini, dazu gebratene Mie Nudeln (Auch vegan möglich",1,4369903,99.99675061,
2314,"Im Tempurateig frittierte Hähnchenbrust auf buntem Gemüse, dazu Basmati Reis (Vegan",1,4369904,99.99677349,
2315,Hähnchen Thai Sweet Chili mit gebratenen Mie Nudeln ODER Reis -Auch vegan möglich,1,4369905,99.99679637,
2316,Pfingsten,1,4369906,99.99681925,
2317,Frischer Spargel am Grill...bald ist die Saison vorbei!,1,4369907,99.99684214,
2318,WM Menü am Grill,1,4369908,99.99686502,
2319,Aktionswoche Südsee heute Tuvalu,1,4369909,99.9968879,
2320,Aktionswoche Südsee heute Pitcairn,1,4369910,99.99691079,
2321,Aktionswoche Südsee heute Samoa,1,4369911,99.99693367,
2322,EG Nord 11.30 - 14.30 Uhr,1,4369912,99.99695655,
2323,"Hähnchenbrust im Backteig auf frischem Wokgemüse, dazu gebratene Mie Nudeln (Auch vegan möglich",1,4369913,99.99697944,
2324,HEIMSPIEL | MG Nord 11.30 - 21.00 Uhr,1,4369914,99.99700232,
2325,"MEISTERWERK | EG Nord, 11.30 - 14.30 Uhr",1,4369915,99.9970252,
2326,95 Jahre Studentenwerk Dresden,1,4369916,99.99704809,
2327,"Schweineschnitzel mit Paprikasoße, buntem Gemüse und Petersilienkartoffeln ODER vegetarisch",1,4369917,99.99707097,
2328,Tellergericht 9,1,4369918,99.99709385,
2329,"Dessert 0,95",1,4369919,99.99711673,
2330,"Currywurst mit Pommes frites, dazu Salat (Barzahlungspreis",1,4369920,99.99713962,
2331,"Fladenbrot-Burger mit Hirtenkäse oder Blumenkohl-Käseburger, dazu Tsatsiki-Dip und Pommes frites (Barzahlungspreis",1,4369921,99.9971625,
2332,Durch Deutschland Regionen-Heute,1,4369922,99.99718538,
2333,Bauerngulasch mit Spätzle oder Kartoffeln (Salat nach Wunsch/ Portion,1,4369923,99.99720827,
2334,Schweineschnitzel mit Zitronenecke und Pommes frites ---ODER Schweineschnitzel mit Cremechampignons und Pommes frites/ Petersilienkartoffeln,1,4369924,99.99723115,
2335,"Schweineschnitzel mit Zitronenecke und Pommes frites ODER Bergbauernschnitzel mit Bratkartoffeln oder Pommes frites, dazu Salat",1,4369925,99.99725403,
2336,Der Renner,1,4369926,99.99727692,
2337,Angebot 3 a,1,4369927,99.9972998,
2338,Schülermenü vegetarisch,1,4369928,99.99732268,
2339,Aktionswoche Südsee heute Tahiti,1,4369929,99.99734557,
2340,New Yorker Delis Pflaumenzimmes,1,4369930,99.99736845,
2341,WM Spezial am Grill,1,4369931,99.99739133,
2342,London Gefilte Fisch fritt,1,4369932,99.99741421,
2343,"Konzert ""Survival Paket"" (15:00 Uhr)",1,4369933,99.9974371,
2344,Nacht der Klänge Spanisches Dessert,1,4369934,99.99745998,
2345,AmGrill,1,4369935,99.99748286,
2346,Burger am  Grill,1,4369936,99.99750575,
2347,Cafeteria Menü Oktoberfest Menü,1,4369937,99.99752863,
2348,Jubiläums Burger,1,4369938,99.99755151,
2349,Pasta  am Wok,1,4369939,99.9975744,
2350,Weinachtsessen am Grill,1,4369940,99.99759728,
2351,Weihnachtliches am Grill,1,4369941,99.99762016,
2352,X-Mas Burger,1,4369942,99.99764304,
2353,Karneval am Kuchenbuffet,1,4369943,99.99766593,
2354,Süß,1,4369944,99.99768881,
2355,Angebot zur Spargelwoche - Hausgemachte Pasta,1,4369945,99.99771169,
2356,Cafeteria Menü vegean,1,4369946,99.99773458,
2357,Cafeteria Men,1,4369947,99.99775746,
2358,"Gebackener Seelachs auf frischem Wokgemüse, dazu gebratene Mie Nudeln (Auch ohne Fisch möglich",1,4369948,99.99778034,
2359,Hausgemachte frische Pasta-Heute,1,4369949,99.99780323,
2360,"Entenbrust mit Soja-Pflaume, Sprossen und Karotten, dazu gebratene Mie Nudeln (auch vegan möglich",1,4369950,99.99782611,
2361,Marokko Agneau aux raisins secs et aux amandes,1,4369951,99.99784899,
2362,"  Gemü­se-Reisp­fanne mit Grün­kern (1,a)      Pepe­ronidip (f,j)      1,80 € / 3,15 €  ",1,4369952,99.99787188,
2363,"  Gemüse­pfanne mit bunten Linsen       Rote Mojo (f,j)       1,80 € / 3,15 €  ",1,4369953,99.99789476,
2364,"  Penne all arrabbiata (a,i)  1,60 € / 2,95 €  ",1,4369954,99.99791764,
2365,"  Soja­ge­sch­netzl­tes­Tikka Masala (3,f,j,m)        2,00 € / 3,60 €  ",1,4369955,99.99794052,
2366,"  Wrap mit Erdbeeren und Vanille­creme (3,a,f)       2,40 € / 3,75 €  ",1,4369956,99.99796341,
2367,"  Scharfe Brat­nudeln mit Wok-Gemüse und Cashew­kernen (2,4,a,f,h,m)       1,60 € / 2,95 €  ",1,4369957,99.99798629,
2368,"  Hähnchen­brust Arabi­sche Art (a)      Mandel- Rosinen­sauce (2,h)       1,70 € / 3,30 €  ",1,4369958,99.99800917,
2369,"  Farfalle­nudeln mit Blatt­spinat (a)      Tomatendip       1,60 € / 2,95 €  ",1,4369959,99.99803206,
2370,"  Hähnchen­brust auf Ratatouille (1,a)        1,70 € / 3,30 €  ",1,4369960,99.99805494,
2371,"  Linguine auf mediterranem Wirsing mit Pinien­kernen (a)       1,60 € / 2,95 €  ",1,4369961,99.99807782,
2372,"  Reis-Spinat­puffer (a)       2,40 € / 3,75 €  ",1,4369962,99.99810071,
2373,"  Bio-Tortellini (a)       Bio-Tomaten­sauce mit Gemüse (a,g,i)       1,95 € / 3,30 €  ",1,4369963,99.99812359,
2374,"  Power Wrap- Middle East- mit Minzdip (3,a,f,h)        2,40 € / 3,75 €  ",1,4369964,99.99814647,
2375,"  Bohnen-Zucchini-Chili mit Vollkorn­reis (3)        2,30 € / 3,65 €  ",1,4369965,99.99816936,
2376,"  Kartof­fel-Brok­ko­li­auflauf (3,c,g,i,k)      Muskat­ve­louté (1,a,g)      1,60 € / 2,95 €  ",1,4369966,99.99819224,
2377,"  Steck­rüben-Bohnen-Paprika-Curry mit Chili­kartoffeln (3,a,f,k)        2,40 € / 3,75 €  ",1,4369967,99.99821512,
2378,"  Klima­Tel­ler: Farfalle­nudeln mit Blatt­spinat (a)      Tomatendip       1,60 € / 2,95 €  ",1,4369968,99.998238,
2379,"  Klima­Tel­ler: Knackige Sauer­kraut­pfanne mit Trauben und Klößen (1,2,f)       1,80 € / 3,15 €  ",1,4369969,99.99826089,
2380,"  Bohnen-Bulgur­ragout mit Champignons, Paprika und Walnüssen, dazu Bananen-So­jas­hake (3,a,e,f,h)       2,60 € / 3,95 €  ",1,4369970,99.99828377,
2381,"  Bio-Ge­mü­sep­fanne mit Dinkel (a)       Bio-Tomaten­sauce (f)       1,95 € / 3,30 €  ",1,4369971,99.99830665,
2382,"  Spaghetti mit Ragout von roten Linsen (a,i)       2,10 € / 3,45 €  ",1,4369972,99.99832954,
2383,"  Asia­ti­sche Gemü­se-Reis­pfanne (m)      Red Thaidip (2)      1,60 € / 2,95 €  ",1,4369973,99.99835242,
2384,"  Italienische Bio-Gemüse­pfanne         1,95 € / 3,30 €  ",1,4369974,99.9983753,
2385,"  Zart­weizen-Kartoffel-Gratin mit Roter Bete und Möhren (a,f)      Frühlings­lauch­sauce (1,a,f)      1,60 € / 2,95 €  ",1,4369975,99.99839819,
2386,"  Bio-Tortellini (a,c)       Bio-Tomaten­sauce mit Gemüse (a,g,i)       1,95 € / 3,30 €  ",1,4369976,99.99842107,
2387,"  Bulgur-Bohnen­salat mit Studen­ten­futter und Rote Bete-Dip (3,a,f,h,k)       2,40 € / 3,75 €  ",1,4369977,99.99844395,
2388,"  Reis-Spinat­puffer (a)      Tomatendip       1,80 € / 3,15 €  ",1,4369978,99.99846684,
2389,"  Vegane Bulette Berliner Art mit geschmorten Zwiebeln und Äpfeln (a,f,j)       2,25 € / 3,60 €  ",1,4369979,99.99848972,
2390,"  Bio-Weizen-Blumen­kohl­bratling (a,c,m) Bio-Lauch­sauce (a,g) 1,95 € / 3,55 €  ",1,4369980,99.9985126,
2391,"  Nasi Goreng (2,4,a,f,m) Melonen-Chili-Sauce 1,60 € / 2,95 €  ",1,4369981,99.99853548,
2392,"  Gers­toni Kürbis-Curry (a)  1,80 € / 3,15 €  ",1,4369982,99.99855837,
2393,"  Gemüse­pfanne mit Rucola  Schnitt­lauchdip (f,j) 1,80 € / 3,15 €  ",1,4369983,99.99858125,
2394,"  Bio-Kartoffel-Brokkoli­auflauf (c,g) Muskat­ve­louté (1,a,g) 1,95 € / 3,30 €  ",1,4369984,99.99860413,
2395,"  Gebackene Süßkartoffel mit Quinoa-Cran­ber­rytop­ping (1,h)  1,80 € / 3,15 €  ",1,4369985,99.99862702,
2396,"  Tagliatelle an Rucola-Nuss­pesto mit Pinien­kernen, dazu eine Grill­tomate (a,h)  2,85 € / 4,20 €  ",1,4369986,99.9986499,
2397,"  Bio-Stangen­spargel  Bio-Kräuter­sauce (a,f) 2,90 € / 4,50 €  ",1,4369987,99.99867278,
2398,"  Falafel-Qui­noa­burger (2,3,a,f,m)  2,60 € / 3,95 €  ",1,4369988,99.99869567,
2399,"  Brat­nudel­pfanne mit Asia­gemüse (2,4,a,f,m) Red Thaidip (2) 1,60 € / 2,95 €  ",1,4369989,99.99871855,
2400,"  Kicher­erbsen-Hirse­pfanne  Minz­c­re­medip (3,f) 1,80 € / 3,15 €  ",1,4369990,99.99874143,
2401,"  Gebratene Thymian­kartoffeln  Grüne Mojo (f,j) 1,60 € / 2,95 €  ",1,4369991,99.99876431,
2402,"  Gemüse­paella mit Vollkorn­reis und Walnüssen (2,4,a,f,h,m)  2,40 € / 3,75 €  ",1,4369992,99.9987872,
2403,"  Gemüse­lasagne mit Sonnen­blumen­kernen (1,2,a,c,g,i) Frühlings­lauch­sauce (1,a,g) 1,80 € / 3,15 €  ",1,4369993,99.99881008,
2404,"  Bio-Tortellini mit Sauce Bolognese (a,c)  2,80 € / 4,15 €  ",1,4369994,99.99883296,
2405,"  Gemüse­pfanne mit Rucola  Paprikadip (f,j) 1,80 € / 3,15 €  ",1,4369995,99.99885585,
2406,"  Bio-Spaghetti (a) Bio-Soja-Bolognese (f) 1,95 € / 3,30 €  ",1,4369996,99.99887873,
2407,"  Auberginen im Haferflocken­mantel mit Tomaten­sauce und Gemüse­bulgur (a)       2,30 € / 3,65 €  ",1,4369997,99.99890161,
2408,"  Curry Couscous mit Pilzen und Zucchini (3,a,f)       Paprikadip (f,j)      2,40 € / 3,75 €  ",1,4369998,99.9989245,
2409,"  Penne all arrabbiata (a,i)       1,60 € / 2,95 €  ",1,4369999,99.99894738,
2410,"  Gebratene Thymian­kartoffeln       Rote Mojo (f,j)       1,80 € / 3,15 €  ",1,4370000,99.99897026,
2411,"  Rote Linsen mit Kokos­curry und Bananen-Soja-Shake (f)        2,85 € / 4,20 €  ",1,4370001,99.99899315,
2412,"  Klima­Tel­ler: Linguine auf mediterranem Wirsing mit Pini­en­kernen (a)       1,60 € / 2,95 €  ",1,4370002,99.99901603,
2413,"  Zart­wei­zen-Gemüse­pfanne (a)      Paprikadip (f,j)      1,60 € / 2,95 €  ",1,4370003,99.99903891,
2414,"  Power Wrap- Middle East- mit Minzdip (3,a,f,h,j)        2,40 € / 3,75 €  ",1,4370004,99.99906179,
2415,"  Soja­sch­netzel Tikka Masala (3,f,j,m)        2,00 € / 3,35 €  ",1,4370005,99.99908468,
2416,"  Klima­Tel­ler: Tortel­li­ni­salat mit klarem Pesto­dressing (2,3,a,e,h,i,k)       316 g CO2äq  2,40 € / 3,75 €  ",1,4370006,99.99910756,
2417,"  Hähnchen­brust Arabi­sche Art (a)      Mandel- Rosi­nensauce (2,h)       1,70 € / 3,30 €  ",1,4370007,99.99913044,
2418,"  Ofen­kar­toffel       Grüne Mojo (f,j)       1,60 € / 2,95 €  ",1,4370008,99.99915333,
2419,"  Steckr­ü­b­en-Bohnen-Paprika-Curry mit Chili­kartoffeln (3,a,f,k)        2,40 € / 3,75 €  ",1,4370009,99.99917621,
2420,"  Grüne Tortel­lini (a,i)       Toma­ten-Ge­mü­sesauce (a,i)      1,80 € / 3,15 €  ",1,4370010,99.99919909,
2421,"  Bolly­wood-Kar­tof­fel­curry mit Brok­koli und Mohn (1,f)        1,80 € / 3,15 €  ",1,4370011,99.99922198,
2422,"  Gebra­tene Udon­nu­deln mit Pilzen und Gemüse (2,a,f,m)       2,00 € / 3,35 €  ",1,4370012,99.99924486,
2423,"  Bohnen-Bul­gur­ra­gout mit Cham­pig­nons, Paprika und Walnüs­sen, dazu Bana­nen-So­jas­hake (3,a,e,f,h)       2,60 € / 3,95 €  ",1,4370013,99.99926774,
2424,"  Bio-Ge­mü­sep­fanne mit Dinkel (a)       Bio-To­ma­tensauce (f)       1,95 € / 3,30 €  ",1,4370014,99.99929063,
2425,"  Spag­hetti mit Ragout von roten Linsen (a,i)       2,10 € / 3,45 €  ",1,4370015,99.99931351,
2426,"  Pizza­puffer mit Fenchel-To­ma­tensauce (1,a,f)       1,60 € / 2,95 €  ",1,4370016,99.99933639,
2427,"  Falafel mit Persi­schem Reis, Pini­en­kernen und Pfir­sich-To­ma­ten­chutney (3,a,k,m)       2,25 € / 3,60 €  ",1,4370017,99.99935927,
2428,"  Acitive Bowl mit mari­nier­tem, Soja­ge­sch­net­zel­tes, gerös­teten Süßkar­tof­feln, Dinkel, Blatt­salat und Senf­dres­sing (3,5,a,e,f,h,j,m)        3,30 € / 4,65 €  ",1,4370018,99.99938216,
2429,"  Farfal­le­nu­deln mit Blatt­spinat (a)      Toma­tendip       1,60 € / 2,95 €  ",1,4370019,99.99940504,
2430,"  Reis­puffer mit Dattel­ratatouille (f,h)       2,30 € / 3,65 €  ",1,4370020,99.99942792,
2431,"  Champignons frisch aus der Pfanne (i)       Aioli (f,j)       1,50 € / 3,10 €  ",1,4370021,99.99945081,
2432,"  Arabi­sche Bowl mit Falafel, Linsen­reis, Rote Bete­hummus und gebackenem Blumen­kohl (a,m)       2,40 € / 3,75 €  ",1,4370022,99.99947369,
2433,"  Gers­toni Bratling mit Möhren (a,f)      Toma­tendip       1,50 € / 3,10 €  ",1,4370023,99.99949657,
2434,"  Nasi Goreng (2,a,f,m)      Melonen-Chili-Sauce 1,60 € / 2,95 €  ",1,4370024,99.99951946,
2435,"  Vegane Bulette Berliner Art mit geschmorten Zwie­beln und Äpfeln (f,j)       2,25 € / 3,60 €  ",1,4370025,99.99954234,
2436,"  Falafel-Qui­noa­burger (2,3,a,f,m)        2,60 € / 3,95 €  ",1,4370026,99.99956522,
2437,"  Bio-Spaghetti (a)       Bio-Soja-Bolognese (f)        1,95 € / 3,30 €  ",1,4370027,99.9995881,
2438,"  Gemüse­curry mit Kicher­erbsen, Linsen und Mango­würfeln        1,80 € / 3,15 €  ",1,4370028,99.99961099,
2439,"  Bio-Kartoffel-Brokkoli­auflauf (c,g)       Bio-Mus­kat­ve­louté (a,g)       1,95 € / 3,30 €  ",1,4370029,99.99963387,
2440,"  Bio-Soja-Bolognese (f)        Bio-Spaghetti (a)       1,95 € / 3,30 €  ",1,4370030,99.99965675,
2441,"  Gemüse-Reis­pfanne mit Grün­kern (1,a)      Peperonidip (f,j)      1,60 € / 2,95 €  ",1,4370031,99.99967964,
2442,Nachmittagsangebot IV,1,4370032,99.99970252,
2443,"  Pommes Sticks       Vegane Dänische Remoulade (2,3,9,f,i,j,k)      1,60 € / 2,95 €  ",1,4370033,99.9997254,
2444,"  Burrito mit Guaca­mole (3,a,f)        2,40 € / 3,75 €  ",1,4370034,99.99974829,
2445,"  Brat­nudel­pfanne mit Asia­gemüse (2,a,f,m)      Red Thaidip (2)      1,60 € / 2,95 €  ",1,4370035,99.99977117,
2446,"  Grün­kohl­b­rat­ling (2,a,f,j)       Tomatendip       1,30 € / 2,90 €  ",1,4370036,99.99979405,
2447,"  Kicher­erbsen-Hirse­pfanne       Minz­c­re­medip (3,f)       1,80 € / 3,15 €  ",1,4370037,99.99981694,
2448,"  Gebratene Thymian­kartoffeln       Grüne Mojo (f,j)       1,60 € / 2,95 €  ",1,4370038,99.99983982,
2449,"  Gemüse­paella mit Voll­kornreis und Walnüssen (2,a,f,h,m)        2,40 € / 3,75 €  ",1,4370039,99.9998627,
2450,"  Blumen­kohl im Back­teig (a,c,g)      Kressedip (g,j)      1,50 € / 3,10 €  ",1,4370040,99.99988558,
2451,"  Gemüse­pfanne mit Rucola       Paprikadip (f,j)      1,80 € / 3,15 €  ",1,4370041,99.99990847,
2452,"  Bio-Spag­hetti (a)       Bio-So­ja-Bolognese (f)        1,95 € / 3,30 €  ",1,4370042,99.99993135,
2453,"  Auberginen im Haferflocken­mantel mit Toma­tensauce und Gemüse­bulgur (a)       2,30 € / 3,65 €  ",1,4370043,99.99995423,
2454,"  Curry Couscous mit Pilzen und Zucchini (3,a,f)       Minz­c­re­medip (3,f)       2,40 € / 3,75 €  ",1,4370044,99.99997712,
2455,"  Grüne Tortellini (a,i)       Tomaten­sauce       1,80 € / 3,15 €  ",1,4370045,100,
